term,Negative freq,Plot freq,Positive freq,score,cnt,logcnt
process,4,6,9,0.03787433940105696,13,3.700439718141092
catherine,0,3,1,0.007574867880211391,1,0.0
sudden,1,2,1,-0.0001174398120963021,2,1.0
which,53,21,53,-0.010745742806811509,106,6.727920454563199
hunnam,0,2,1,0.007574867880211391,1,0.0
college,9,4,4,-0.038755137991779216,13,3.700439718141092
charlie,1,4,7,0.04568408690546095,8,3.0
about,143,39,153,0.05566647093364652,296,8.20945336562895
severe,1,1,1,-0.0001174398120963021,2,1.0
facts,1,1,2,0.0075161479741632405,3,1.5849625007211563
faces,4,2,1,-0.023194362889019382,5,2.321928094887362
all,164,46,167,0.03241338813857897,331,8.370687406807217
under,18,11,14,-0.031650029359953036,32,5.0
between,27,18,37,0.07469172049324718,64,6.0
possible,6,4,9,0.022489724016441573,15,3.9068905956085187
continues,0,5,4,0.03047563123899002,4,2.0
year,32,23,60,0.18890193775689962,92,6.523561956057013
burke,0,1,1,0.007574867880211391,1,0.0
already,14,3,6,-0.0619495008807986,20,4.321928094887363
from,154,79,165,0.040164415736934744,319,8.31741261376487
she,18,73,20,0.014151497357604209,38,5.247927513443585
job,8,11,11,0.02237228420434527,19,4.247927513443585
police,5,10,2,-0.02325308279506753,7,2.807354922057604
man,25,37,45,0.1511450381679389,70,6.129283016944967
absence,1,1,1,-0.0001174398120963021,2,1.0
land,4,6,4,-0.00029359953024075264,8,3.0
past,14,12,12,-0.016147974163241346,26,4.700439718141093
passions,0,1,3,0.022842043452730474,3,1.5849625007211563
holmes,1,2,0,-0.007751027598355844,1,0.0
memory,4,3,10,0.0455079271873165,14,3.8073549220576037
possibilities,1,2,1,-0.0001174398120963021,2,1.0
young,16,23,23,0.05243687610099823,39,5.285402218862249
begins,4,15,12,0.06077510275983558,16,4.0
at,152,61,152,0.024955960070463967,304,8.247927513443585
investigating,1,4,0,-0.007751027598355844,1,0.0
whose,14,6,9,-0.03904873752201997,23,4.523561956057013
to,1010,556,942,0.00023487962419255215,1952,10.930737337562887
complete,8,5,5,-0.023429242513211983,13,3.700439718141092
pressure,1,2,2,0.0075161479741632405,3,1.5849625007211563
surprising,8,1,9,0.0071051086318261875,17,4.08746284125034
two,32,34,43,0.08203170874926602,75,6.22881869049588
new,48,55,47,-0.010510863182618901,95,6.569855608330948
is,726,293,818,0.00804462712859666,1544,10.592457037268082
his,107,256,161,0.11714621256605984,268,8.066089190457772
the,2288,1007,2346,0.0,4634,12.178042328864823
unexplained,1,2,0,-0.007751027598355844,1,0.0
and,1179,556,1637,0.0078097475044039966,2816,11.459431618637298
another,51,12,34,-0.12513211978860833,85,6.409390936137703
after,45,45,20,-0.1935408103347035,65,6.022367813028454
forced,11,8,2,-0.06940692894891369,13,3.700439718141092
confront,0,3,1,0.007574867880211391,1,0.0
as,441,141,430,-0.007046388725778119,871,9.766528908598865
old,44,25,53,0.05079271873165003,97,6.599912842187128
detective,0,10,5,0.03810921902524956,5,2.321928094887362
a,1613,674,1775,5.871990604811028e-05,3388,11.7262181593322
wade,1,3,0,-0.007751027598355844,1,0.0
her,25,184,39,0.10534351145038168,64,6.0
even,92,12,85,-0.01990604815032293,177,7.467605550082998
of,1235,457,1480,-0.007516147974163334,2715,11.406736482691723
choose,3,3,1,-0.015502055196711688,4,2.0
bratt,1,1,0,-0.007751027598355844,1,0.0
must,16,18,14,-0.01626541397533765,30,4.906890595608519
connection,0,2,3,0.022842043452730474,3,1.5849625007211563
an,256,133,333,0.04703464474456842,589,9.20212382383046
when,76,82,43,-0.21027598355842625,119,6.894817763307944
for,364,152,376,0.008455666470933543,740,9.531381460516313
meets,2,12,3,0.0074574280681150885,5,2.321928094887362
nick,1,10,1,-0.0001174398120963021,2,1.0
in,622,312,676,0.0004697592483852153,1298,10.342074667999139
helps,0,1,5,0.03810921902524956,5,2.321928094887362
be,265,43,198,-0.014092777451556016,463,8.854868383260238
commitment,1,1,0,-0.007751027598355844,1,0.0
how,56,11,45,-0.07193188490898417,101,6.6582114827517955
cool,13,1,7,-0.046623605402231365,20,4.321928094887363
gradually,0,3,3,0.022842043452730474,3,1.5849625007211563
hope,11,5,14,0.022196124486200813,25,4.643856189774724
hugh,4,2,7,0.02260716382853787,11,3.4594316186372978
school,13,21,9,-0.031356429829712276,22,4.459431618637297
teaches,1,3,0,-0.007751027598355844,1,0.0
one,188,51,194,0.03217850851438642,382,8.57742882803575
starts,10,10,4,-0.04644744568408691,14,3.8073549220576037
novel,10,1,7,-0.023546682325308287,17,4.08746284125034
s,749,226,808,-0.007281268349970671,1557,10.604553229079038
him,18,62,27,0.06758661186142101,45,5.491853096329675
free,6,4,3,-0.023311802701115682,9,3.1699250014423126
start,11,7,5,-0.04650616559013506,16,4.0
son,0,17,3,0.022842043452730474,3,1.5849625007211563
alone,10,4,6,-0.031180270111567827,16,4.0
on,207,137,217,0.02425132119788609,424,8.727920454563199
finally,9,8,8,-0.008220786846741046,17,4.08746284125034
himself,9,19,6,-0.023487962419260135,15,3.9068905956085187
up,127,51,98,-0.020434527304756367,225,7.813781191217037
become,10,16,16,0.04515560775102759,26,4.700439718141093
will,80,38,92,0.06435701702877272,172,7.426264754702098
single,8,6,7,-0.008162066940692901,15,3.9068905956085187
continued,0,2,1,0.007574867880211391,1,0.0
12,1,5,4,0.022783323546682326,5,2.321928094887362
they,89,102,53,-0.2030534351145038,142,7.149747119504682
ability,3,1,8,0.03793305930710511,11,3.4594316186372978
he,65,157,93,0.16429829712272453,158,7.303780748177103
hip,12,5,3,-0.06946564885496184,15,3.9068905956085187
based,6,10,14,0.06065766294773928,20,4.321928094887363
realizes,1,3,1,-0.0001174398120963021,2,1.0
irresponsible,2,2,1,-0.007809747504403995,3,1.5849625007211563
women,7,17,5,-0.01573693482090429,12,3.5849625007211565
comedy,89,7,90,0.025954198473282508,179,7.483815777264256
married,1,7,1,-0.0001174398120963021,2,1.0
result,8,3,5,-0.023429242513211983,13,3.700439718141092
many,45,7,46,0.004932472108044594,91,6.507794640198696
ways,11,4,15,0.029829712272460354,26,4.700439718141093
day,14,25,31,0.12889019377568994,45,5.491853096329675
problems,7,1,5,-0.01573693482090429,12,3.5849625007211565
are,154,62,161,0.03253082795067519,315,8.29920801838728
grow,2,2,1,-0.007809747504403995,3,1.5849625007211563
kid,7,2,12,0.0376981796829125,19,4.247927513443585
with,317,170,441,0.03904873752201998,758,9.566054038171092
behind,5,12,8,0.022548443922489725,13,3.700439718141092
ask,4,1,2,-0.015560775102759838,6,2.584962500721156
friends,3,19,3,-0.0002348796241926042,6,2.584962500721156
string,4,1,2,-0.015560775102759838,6,2.584962500721156
rich,2,4,11,0.06852613035819143,13,3.700439718141092
them,46,28,44,-0.018027011156782125,90,6.491853096329675
child,5,5,3,-0.01561949500880799,8,3.0
life,42,73,66,0.1577803875513799,108,6.754887502163469
marcus,3,5,1,-0.015502055196711688,4,2.0
starring,3,1,4,0.00739870816206694,7,2.807354922057604
opposite,2,2,0,-0.015443335290663537,2,1.0
popular,0,6,9,0.06864357017028773,9,3.1699250014423126
father,1,26,4,0.022783323546682326,5,2.321928094887362
involved,8,2,3,-0.03869641808573107,11,3.4594316186372978
boy,9,14,17,0.060481503229594835,26,4.700439718141093
that,602,151,617,0.0005284791544333256,1219,10.251482410620213
drama,28,6,53,0.1738696418085731,81,6.339850002884625
who,88,107,112,0.10234879624192605,200,7.643856189774724
search,4,8,5,0.007339988256018788,9,3.1699250014423126
odd,5,3,3,-0.01561949500880799,8,3.0
meet,2,4,2,-0.00017615971814445228,4,2.0
cold,10,1,5,-0.03881385789782737,15,3.9068905956085187
but,372,75,382,0.008396946564885432,754,9.558420713268665
grant,7,4,21,0.10640046975924838,28,4.807354922057604
leaves,13,5,4,-0.06952436876100998,17,4.08746284125034
available,0,1,2,0.015208455666470933,2,1.0
leave,13,6,15,0.014445096887844969,28,4.807354922057604
hornby,0,1,2,0.015208455666470933,2,1.0
british,2,6,2,-0.00017615971814445228,4,2.0
imaginary,1,1,0,-0.007751027598355844,1,0.0
has,163,92,178,0.0630064591896653,341,8.413627929024173
nicholson,1,1,11,0.07621843805049912,12,3.5849625007211565
come,27,10,26,-0.009277745155607753,53,5.7279204545632
daughter,2,15,6,0.030358191426893714,8,3.0
care,18,3,10,-0.0621843805049912,28,4.807354922057604
deal,8,3,11,0.02237228420434527,19,4.247927513443585
failure,6,2,3,-0.023311802701115682,9,3.1699250014423126
schmidt,1,1,10,0.06858485026423958,11,3.4594316186372978
does,40,9,55,0.09682912507339991,95,6.569855608330948
enters,1,1,1,-0.0001174398120963021,2,1.0
terms,3,2,12,0.06846741045214327,15,3.9068905956085187
warren,0,1,2,0.015208455666470933,2,1.0
wife,3,10,1,-0.015502055196711688,4,2.0
soon,5,17,2,-0.02325308279506753,7,2.807354922057604
future,9,10,6,-0.023487962419260135,15,3.9068905956085187
ambiguous,1,1,1,-0.0001174398120963021,2,1.0
passes,3,1,2,-0.007868467410452145,5,2.321928094887362
away,24,10,15,-0.07017028772753965,39,5.285402218862249
marriage,2,5,1,-0.007809747504403995,3,1.5849625007211563
not,204,30,161,-0.04439224897240168,365,8.51175265376738
susan,0,1,2,0.015208455666470933,2,1.0
fiction,6,1,7,0.007222548443922484,13,3.700439718141092
book,11,4,22,0.08326482677627714,33,5.044394119358453
rare,3,4,20,0.1295361127422196,23,4.523561956057013
dealer,1,6,0,-0.007751027598355844,1,0.0
orchid,0,1,1,0.007574867880211391,1,0.0
this,388,46,319,-0.02982971227246034,707,9.4655664048094
clones,1,2,4,0.022783323546682326,5,2.321928094887362
attempt,11,7,4,-0.0541397533763946,15,3.9068905956085187
see,44,6,47,0.02025836758661187,91,6.507794640198696
movie,424,10,313,-0.052789195537287115,737,9.52552080909507
somewhat,3,4,9,0.04556664709336465,12,3.5849625007211565
it,801,88,826,0.00029359953024077345,1627,10.667998535672528
cage,6,3,3,-0.023311802701115682,9,3.1699250014423126
into,78,45,84,0.02630651790957128,162,7.339850002884624
action,84,7,48,-0.2028772753963593,132,7.044394119358453
struggle,1,4,5,0.030416911332941866,6,2.584962500721156
story,102,32,132,0.08672930123311806,234,7.870364719583405
screenwriter,5,2,5,-0.00035231943628890455,10,3.3219280948873626
real,29,15,41,0.08984145625366996,70,6.129283016944967
john,23,16,15,-0.06247798003523196,38,5.247927513443585
non,4,3,5,0.007339988256018788,9,3.1699250014423126
cooper,2,2,1,-0.007809747504403995,3,1.5849625007211563
true,13,13,27,0.10604815032295947,40,5.321928094887363
we,64,8,72,0.0498532002348796,136,7.08746284125034
account,1,1,3,0.015149735760422781,4,2.0
kaufman,0,3,12,0.09154433352906635,12,3.5849625007211565
adaptation,5,1,11,0.04544920728126835,16,4.0
then,30,20,23,-0.05525543159130947,53,5.7279204545632
orlean,0,1,1,0.007574867880211391,1,0.0
instead,32,7,7,-0.1927774515560775,39,5.285402218862249
evil,8,14,4,-0.031062830299471524,12,3.5849625007211565
great,23,5,61,0.2657662947739283,84,6.39231742277876
ali,3,2,1,-0.015502055196711688,4,2.0
government,1,9,0,-0.007751027598355844,1,0.0
voice,2,3,3,0.0074574280681150885,5,2.321928094887362
by,201,105,197,0.016735173223722866,398,8.63662462054365
g,1,1,1,-0.0001174398120963021,2,1.0
down,36,24,28,-0.06324133881385788,64,6.0
than,175,26,174,0.03229594832648264,349,8.447083226209653
plot,65,3,34,-0.20974750440399298,99,6.6293566200796095
becomes,16,14,7,-0.06970052847915445,23,4.523561956057013
pawn,1,1,0,-0.007751027598355844,1,0.0
prime,3,3,2,-0.007868467410452145,5,2.321928094887362
nation,1,3,1,-0.0001174398120963021,2,1.0
however,7,17,4,-0.02337052260716383,11,3.4594316186372978
more,194,34,170,-0.006106870229007688,364,8.507794640198696
ever,40,5,35,-0.04057545507927185,75,6.22881869049588
youth,0,2,2,0.015208455666470933,2,1.0
making,19,10,23,0.029359953024075153,42,5.392317422778761
bringing,2,1,6,0.030358191426893714,8,3.0
caught,1,3,3,0.015149735760422781,4,2.0
where,39,20,22,-0.13211978860833826,61,5.930737337562887
skipped,1,1,0,-0.007751027598355844,1,0.0
hunter,0,3,1,0.007574867880211391,1,0.0
aside,4,1,6,0.014973576042278329,10,3.3219280948873626
team,7,9,5,-0.01573693482090429,12,3.5849625007211565
differences,1,5,2,0.0075161479741632405,3,1.5849625007211563
put,11,6,8,-0.02360540223135643,19,4.247927513443585
their,53,99,73,0.1190252495596007,126,6.977279923499917
wind,4,1,1,-0.023194362889019382,5,2.321928094887362
witness,0,2,2,0.015208455666470933,2,1.0
scam,1,1,0,-0.007751027598355844,1,0.0
works,10,6,26,0.12149148561362302,36,5.169925001442312
emotional,16,3,24,0.060070463887257786,40,5.321928094887363
together,16,22,23,0.05243687610099823,39,5.285402218862249
guy,10,4,2,-0.061714621256606,12,3.5849625007211565
joy,2,1,5,0.022724603640634174,7,2.807354922057604
supermarket,1,1,0,-0.007751027598355844,1,0.0
unexpected,1,4,8,0.053317674691720496,9,3.1699250014423126
philosophical,2,1,7,0.037991779213153255,9,3.1699250014423126
stories,4,3,8,0.030240751614797418,12,3.5849625007211565
whom,4,5,4,-0.00029359953024075264,8,3.0
tragedy,4,4,8,0.030240751614797418,12,3.5849625007211565
estate,1,2,0,-0.007751027598355844,1,0.0
class,9,4,11,0.014679976512037576,20,4.321928094887363
dry,4,1,7,0.02260716382853787,11,3.4594316186372978
aggressive,0,2,1,0.007574867880211391,1,0.0
over,60,19,32,-0.20193775689958898,92,6.523561956057013
lives,6,13,12,0.045390487375220195,18,4.169925001442312
love,25,39,61,0.25038167938931294,86,6.426264754702098
out,117,66,93,-0.0280093951849677,210,7.714245517666122
nothing,58,5,29,-0.2094539048737522,87,6.442943495848729
people,41,16,28,-0.10170287727539637,69,6.10852445677817
taxi,0,2,2,0.015208455666470933,2,1.0
housing,0,1,1,0.007574867880211391,1,0.0
rediscover,0,1,1,0.007574867880211391,1,0.0
gentle,2,2,6,0.030358191426893714,8,3.0
tells,3,8,4,0.00739870816206694,7,2.807354922057604
home,20,21,13,-0.05466823253082796,33,5.044394119358453
journey,2,9,9,0.053258954785672344,11,3.4594316186372978
working,4,11,9,0.03787433940105696,13,3.700439718141092
gone,16,2,6,-0.07733411626541398,22,4.459431618637297
run,18,11,8,-0.07745155607751028,26,4.700439718141093
london,1,5,1,-0.0001174398120963021,2,1.0
or,130,16,94,-0.03576042278332359,224,7.807354922057604
experience,8,7,11,0.02237228420434527,19,4.247927513443585
brought,0,6,4,0.03047563123899002,4,2.0
long,51,12,24,-0.20146799765120374,75,6.22881869049588
family,21,34,43,0.1666470933646506,64,6.0
also,28,20,46,0.13570170287727537,74,6.209453365628951
set,19,19,11,-0.06224310041103935,30,4.906890595608519
some,73,20,89,0.08755137991779216,162,7.339850002884624
checkout,1,1,0,-0.007751027598355844,1,0.0
driver,2,2,2,-0.00017615971814445228,4,2.0
occurs,2,1,1,-0.007809747504403995,3,1.5849625007211563
range,2,1,3,0.0074574280681150885,5,2.321928094887362
prison,3,17,2,-0.007868467410452145,5,2.321928094887362
niro,15,2,9,-0.04674104521432766,24,4.584962500721157
help,4,20,9,0.03787433940105696,13,3.700439718141092
stock,6,1,4,-0.015678214914856138,10,3.3219280948873626
serious,13,3,12,-0.008455666470933654,25,4.643856189774724
dr,1,7,1,-0.0001174398120963021,2,1.0
crystal,3,1,2,-0.007868467410452145,5,2.321928094887362
paul,3,4,3,-0.0002348796241926042,6,2.584962500721156
back,27,25,23,-0.03217850851438639,50,5.643856189774724
finds,6,23,8,0.014856136230182032,14,3.8073549220576037
naturally,2,1,0,-0.015443335290663537,2,1.0
ben,4,11,0,-0.030827950675278923,4,2.0
well,70,8,81,0.04950088079859083,151,7.238404739325079
needs,7,8,6,-0.00810334703464475,13,3.700439718141092
excess,2,1,1,-0.007809747504403995,3,1.5849625007211563
stress,1,1,0,-0.007751027598355844,1,0.0
de,32,4,40,0.05913094539048741,72,6.169925001442312
returns,0,7,2,0.015208455666470933,2,1.0
practice,0,1,2,0.015208455666470933,2,1.0
need,18,6,21,0.021785085143863764,39,5.285402218862249
gets,27,6,24,-0.024544920728126834,51,5.672425341971496
through,45,9,41,-0.033235466823253124,86,6.426264754702098
derek,1,1,1,-0.0001174398120963021,2,1.0
sent,0,18,1,0.007574867880211391,1,0.0
prone,0,1,1,0.007574867880211391,1,0.0
naval,0,1,1,0.007574867880211391,1,0.0
horrific,1,2,0,-0.007751027598355844,1,0.0
luke,0,1,1,0.007574867880211391,1,0.0
doctor,1,3,1,-0.0001174398120963021,2,1.0
painful,7,3,5,-0.01573693482090429,12,3.5849625007211565
first,38,26,62,0.15801526717557252,100,6.643856189774725
breaks,2,2,2,-0.00017615971814445228,4,2.0
violent,5,4,3,-0.01561949500880799,8,3.0
reveals,1,2,5,0.030416911332941866,6,2.584962500721156
washington,3,2,12,0.06846741045214327,15,3.9068905956085187
find,15,31,22,0.05249559600704637,37,5.20945336562895
never,58,14,64,0.034820904286553156,122,6.930737337562887
eventually,8,5,5,-0.023429242513211983,13,3.700439718141092
outbursts,3,1,0,-0.02313564298297123,3,1.5849625007211563
refusing,0,1,1,0.007574867880211391,1,0.0
quest,0,5,3,0.022842043452730474,3,1.5849625007211563
open,3,6,9,0.04556664709336465,12,3.5849625007211565
childhood,1,5,0,-0.007751027598355844,1,0.0
knew,1,4,3,0.015149735760422781,4,2.0
epic,4,4,9,0.03787433940105696,13,3.700439718141092
historical,1,1,7,0.04568408690546095,8,3.0
armenian,2,1,2,-0.00017615971814445228,4,2.0
within,1,4,5,0.030416911332941866,6,2.584962500721156
1915,1,1,1,-0.0001174398120963021,2,1.0
line,14,1,12,-0.016147974163241346,26,4.700439718141093
film,272,26,361,0.039283617146212646,633,9.306061689428342
contemporary,2,2,8,0.0456253669994128,10,3.3219280948873626
holocaust,1,3,0,-0.007751027598355844,1,0.0
production,20,2,7,-0.10046975924838522,27,4.754887502163469
transforms,0,1,1,0.007574867880211391,1,0.0
follows,3,8,4,0.00739870816206694,7,2.807354922057604
hired,0,3,1,0.007574867880211391,1,0.0
world,11,42,26,0.11379917792131533,37,5.20945336562895
girlfriend,0,7,1,0.007574867880211391,1,0.0
connect,3,1,3,-0.0002348796241926042,6,2.584962500721156
track,1,7,1,-0.0001174398120963021,2,1.0
escaped,2,3,1,-0.007809747504403995,3,1.5849625007211563
master,2,5,1,-0.007809747504403995,3,1.5849625007211563
1975,3,2,0,-0.02313564298297123,3,1.5849625007211563
mini,0,2,2,0.015208455666470933,2,1.0
powers,5,6,11,0.04544920728126835,16,4.0
plan,2,10,1,-0.007809747504403995,3,1.5849625007211563
large,6,2,5,-0.008044627128596597,11,3.4594316186372978
me,35,2,25,-0.07844979448032885,60,5.906890595608519
time,97,34,85,-0.027598355842630706,182,7.507794640198696
somehow,4,1,6,0.014973576042278329,10,3.3219280948873626
save,10,8,1,-0.06934820904286554,11,3.4594316186372978
austin,6,2,9,0.022489724016441573,15,3.9068905956085187
security,1,6,0,-0.007751027598355844,1,0.0
stops,2,3,2,-0.00017615971814445228,4,2.0
chases,5,2,2,-0.02325308279506753,7,2.807354922057604
domination,0,1,1,0.007574867880211391,1,0.0
requires,1,1,0,-0.007751027598355844,1,0.0
goldmember,4,2,4,-0.00029359953024075264,8,3.0
england,1,1,2,0.0075161479741632405,3,1.5849625007211563
amount,3,2,4,0.00739870816206694,7,2.807354922057604
particular,4,2,1,-0.023194362889019382,5,2.321928094887362
villains,1,2,2,0.0075161479741632405,3,1.5849625007211563
travel,1,2,2,0.0075161479741632405,3,1.5849625007211563
have,173,38,126,-0.05161479741632413,299,8.224001674198107
spy,19,3,12,-0.05460951262477981,31,4.954196310386876
kidnapping,1,1,0,-0.007751027598355844,1,0.0
document,0,3,4,0.03047563123899002,4,2.0
spirit,7,2,17,0.07586611861421022,24,4.584962500721157
fame,0,6,3,0.022842043452730474,3,1.5849625007211563
having,10,8,11,0.006987668819729884,21,4.392317422778761
60s,1,1,6,0.03805049911920141,7,2.807354922057604
officially,1,1,0,-0.007751027598355844,1,0.0
technician,0,1,1,0.007574867880211391,1,0.0
crane,2,2,5,0.022724603640634174,7,2.807354922057604
very,57,12,57,-0.0032883147386964517,114,6.832890014164742
heroes,4,2,6,0.014973576042278329,10,3.3219280948873626
carpenter,3,1,1,-0.015502055196711688,4,2.0
greg,1,1,1,-0.0001174398120963021,2,1.0
70s,3,2,1,-0.015502055196711688,4,2.0
led,0,7,1,0.007574867880211391,1,0.0
video,39,4,11,-0.21608925425719322,50,5.643856189774724
hogan,0,1,1,0.007574867880211391,1,0.0
may,39,5,75,0.22665883734586023,114,6.832890014164742
association,1,1,0,-0.007751027598355844,1,0.0
star,26,10,33,0.05184967704051671,59,5.882643049361842
murder,10,19,4,-0.04644744568408691,14,3.8073549220576037
bob,2,2,2,-0.00017615971814445228,4,2.0
numerous,1,3,1,-0.0001174398120963021,2,1.0
unsolved,0,2,1,0.007574867880211391,1,0.0
room,6,7,7,0.007222548443922484,13,3.700439718141092
exploits,2,1,1,-0.007809747504403995,3,1.5849625007211563
1978,1,1,0,-0.007751027598355844,1,0.0
kinnear,0,1,9,0.06864357017028773,9,3.1699250014423126
remains,8,2,8,-0.0005284791544333534,16,4.0
so,178,21,110,-0.08990017615971813,288,8.169925001442312
days,15,5,6,-0.06964180857310628,21,4.392317422778761
american,9,14,33,0.1826189078097475,42,5.392317422778761
no,130,22,65,-0.20369935408103346,195,7.607330313749611
rescue,2,2,1,-0.007809747504403995,3,1.5849625007211563
harvard,11,3,0,-0.08467410452143277,11,3.4594316186372978
city,7,14,7,-0.0004697592483852084,14,3.8073549220576037
was,69,28,38,-0.20998238402818553,107,6.7414669864011465
african,3,5,4,0.00739870816206694,7,2.807354922057604
finish,6,1,7,0.007222548443922484,13,3.700439718141092
enemy,1,6,1,-0.0001174398120963021,2,1.0
like,219,12,147,-0.08267762771579568,366,8.515699838284043
hopkins,9,3,3,-0.046388725778038764,12,3.5849625007211565
train,3,5,2,-0.007868467410452145,5,2.321928094887362
killed,1,12,1,-0.0001174398120963021,2,1.0
worked,5,1,4,-0.007985907222548445,9,3.1699250014423126
york,6,17,11,0.037756899588960655,17,4.08746284125034
sends,0,6,1,0.007574867880211391,1,0.0
jake,0,4,1,0.007574867880211391,1,0.0
k,9,4,9,-0.0005871990604815053,18,4.169925001442312
arms,1,3,1,-0.0001174398120963021,2,1.0
idea,22,5,9,-0.10058719906048151,31,4.954196310386876
nine,1,1,0,-0.007751027598355844,1,0.0
coming,7,5,8,0.007163828537874339,15,3.9068905956085187
rock,15,3,10,-0.03910745742806812,25,4.643856189774724
during,10,13,5,-0.03881385789782737,15,3.9068905956085187
nuclear,2,5,0,-0.015443335290663537,2,1.0
anthony,6,2,1,-0.03857897827363477,7,2.807354922057604
chris,8,4,4,-0.031062830299471524,12,3.5849625007211565
act,14,4,10,-0.03141514973576043,24,4.584962500721157
secret,1,15,1,-0.0001174398120963021,2,1.0
identity,1,5,2,0.0075161479741632405,3,1.5849625007211563
agent,1,16,1,-0.0001174398120963021,2,1.0
cia,0,7,1,0.007574867880211391,1,0.0
place,13,9,17,0.029712272460364064,30,4.906890595608519
twin,0,7,2,0.015208455666470933,2,1.0
absolutely,6,1,9,0.022489724016441573,15,3.9068905956085187
terrorist,4,1,0,-0.030827950675278923,4,2.0
let,13,4,3,-0.07715795654726954,16,4.0
street,3,7,4,0.00739870816206694,7,2.807354922057604
wise,7,2,5,-0.01573693482090429,12,3.5849625007211565
brother,3,11,10,0.05320023487962419,13,3.700439718141092
turner,0,1,1,0.007574867880211391,1,0.0
michael,11,16,16,0.037463300058719895,27,4.754887502163469
experienced,2,1,2,-0.00017615971814445228,4,2.0
talk,4,3,3,-0.007927187316500297,7,2.807354922057604
wants,10,17,4,-0.04644744568408691,14,3.8073549220576037
had,37,10,20,-0.13200234879624195,57,5.832890014164742
learn,2,6,2,-0.00017615971814445228,4,2.0
hustler,1,2,1,-0.0001174398120963021,2,1.0
terrorists,1,1,0,-0.007751027598355844,1,0.0
fill,2,1,1,-0.007809747504403995,3,1.5849625007211563
project,12,2,8,-0.031297709923664124,20,4.321928094887363
what,98,23,127,0.09448032883147384,225,7.813781191217037
jonathan,0,2,1,0.007574867880211391,1,0.0
ecks,7,1,0,-0.053904873752202,7,2.807354922057604
developed,0,2,1,0.007574867880211391,1,0.0
combat,2,3,0,-0.015443335290663537,2,1.0
order,5,8,3,-0.01561949500880799,8,3.0
dia,1,1,0,-0.007751027598355844,1,0.0
antonio,2,1,0,-0.015443335290663537,2,1.0
can,136,21,101,-0.028185554903112142,237,7.88874324889826
liu,2,1,0,-0.015443335290663537,2,1.0
device,1,2,0,-0.007751027598355844,1,0.0
join,1,1,0,-0.007751027598355844,1,0.0
kill,4,7,1,-0.023194362889019382,5,2.321928094887362
common,4,4,3,-0.007927187316500297,7,2.807354922057604
victims,3,2,2,-0.007868467410452145,5,2.321928094887362
banderas,3,1,0,-0.02313564298297123,3,1.5849625007211563
lucy,5,5,0,-0.038520258367586616,5,2.321928094887362
sever,6,1,0,-0.04621256605989431,6,2.584962500721156
south,3,11,1,-0.015502055196711688,4,2.0
shot,15,6,8,-0.0543746330005872,23,4.523561956057013
vision,1,3,10,0.06858485026423958,11,3.4594316186372978
desperately,4,1,4,-0.00029359953024075264,8,3.0
chicago,4,9,10,0.0455079271873165,14,3.8073549220576037
business,9,6,9,-0.0005871990604815053,18,4.169925001442312
stand,11,1,6,-0.03887257780387552,17,4.08746284125034
cutting,2,2,3,0.0074574280681150885,5,2.321928094887362
get,43,32,36,-0.0560187903699354,79,6.303780748177103
con,4,2,3,-0.007927187316500297,7,2.807354922057604
t,309,23,205,-0.03722842043452734,514,9.005624549193879
eve,1,8,1,-0.0001174398120963021,2,1.0
fellow,0,4,2,0.015208455666470933,2,1.0
seem,25,3,17,-0.06259541984732825,42,5.392317422778761
entertainer,1,1,0,-0.007751027598355844,1,0.0
trying,18,13,11,-0.05455079271873166,29,4.857980995127573
against,4,21,8,0.030240751614797418,12,3.5849625007211565
ex,0,2,1,0.007574867880211391,1,0.0
legacy,0,4,5,0.03810921902524956,5,2.321928094887362
struggling,0,2,2,0.015208455666470933,2,1.0
struggles,0,4,2,0.015208455666470933,2,1.0
selling,0,1,1,0.007574867880211391,1,0.0
strong,11,2,20,0.06799765120375806,31,4.954196310386876
shop,2,5,3,0.0074574280681150885,5,2.321928094887362
calvin,1,6,1,-0.0001174398120963021,2,1.0
waste,12,1,1,-0.08473282442748092,13,3.700439718141092
side,11,2,9,-0.01597181444509689,20,4.321928094887363
stay,8,6,5,-0.023429242513211983,13,3.700439718141092
slowly,2,3,2,-0.00017615971814445228,4,2.0
complex,4,4,11,0.05314151497357604,15,3.9068905956085187
edged,1,1,0,-0.007751027598355844,1,0.0
smart,8,3,24,0.12160892542571933,32,5.0
notion,1,1,1,-0.0001174398120963021,2,1.0
there,127,24,79,-0.11967116852613036,206,7.6865005271832185
just,145,27,76,-0.1733998825601879,221,7.787902559391432
white,7,9,15,0.060598943041691125,22,4.459431618637297
woman,6,21,10,0.030123311802701114,16,4.0
thomas,0,1,4,0.03047563123899002,4,2.0
hair,3,2,4,0.00739870816206694,7,2.807354922057604
sold,1,1,0,-0.007751027598355844,1,0.0
highly,3,2,12,0.06846741045214327,15,3.9068905956085187
cube,4,1,6,0.014973576042278329,10,3.3219280948873626
eddie,4,3,2,-0.015560775102759838,6,2.584962500721156
jokes,28,1,11,-0.13147386964180857,39,5.285402218862249
local,2,11,3,0.0074574280681150885,5,2.321928094887362
filled,5,1,12,0.05308279506752789,17,4.08746284125034
hard,32,3,28,-0.03247210804462711,60,5.906890595608519
straight,13,2,7,-0.046623605402231365,20,4.321928094887363
barbershop,6,2,10,0.030123311802701114,16,4.0
strikes,0,4,5,0.03810921902524956,5,2.321928094887362
hilarious,6,3,28,0.16752789195537288,34,5.08746284125034
timing,2,1,3,0.0074574280681150885,5,2.321928094887362
characters,72,5,57,-0.09559600704638876,129,7.011227255423254
cast,29,4,45,0.12037580739870812,74,6.209453365628951
share,7,4,6,-0.00810334703464475,13,3.700439718141092
doesn,68,9,48,-0.12595419847328243,116,6.857980995127572
psyche,1,1,0,-0.007751027598355844,1,0.0
mental,0,2,2,0.015208455666470933,2,1.0
silence,2,1,7,0.037991779213153255,9,3.1699250014423126
routine,13,2,2,-0.08479154433352908,15,3.9068905956085187
human,8,3,25,0.12924251321197885,33,5.044394119358453
inside,3,7,9,0.04556664709336465,12,3.5849625007211565
submarine,2,3,5,0.022724603640634174,7,2.807354922057604
deceptions,1,1,0,-0.007751027598355844,1,0.0
tiger,1,2,0,-0.007751027598355844,1,0.0
fear,2,6,3,0.0074574280681150885,5,2.321928094887362
ii,10,2,6,-0.031180270111567827,16,4.0
below,4,1,6,0.014973576042278329,10,3.3219280948873626
delusions,0,1,2,0.015208455666470933,2,1.0
trapped,7,4,2,-0.03863769817968292,9,3.1699250014423126
war,18,23,29,0.08285378743394009,47,5.554588851677638
shocked,2,1,1,-0.007809747504403995,3,1.5849625007211563
sea,6,3,5,-0.008044627128596597,11,3.4594316186372978
mission,0,8,1,0.007574867880211391,1,0.0
u,2,4,1,-0.007809747504403995,3,1.5849625007211563
dark,13,4,13,-0.0008220786846741129,26,4.700439718141093
should,58,3,27,-0.2247210804462713,85,6.409390936137703
spaces,0,1,1,0.007574867880211391,1,0.0
ocean,1,3,4,0.022783323546682326,5,2.321928094887362
shell,0,1,1,0.007574867880211391,1,0.0
crew,1,9,4,0.022783323546682326,5,2.321928094887362
surface,6,3,7,0.007222548443922484,13,3.700439718141092
deep,2,2,13,0.08379330593071051,15,3.9068905956085187
sub,4,2,2,-0.015560775102759838,6,2.584962500721156
society,1,3,3,0.015149735760422781,4,2.0
money,15,14,5,-0.07727539635936584,20,4.321928094887363
running,11,4,4,-0.0541397533763946,15,3.9068905956085187
clouds,0,1,4,0.03047563123899002,4,2.0
short,19,4,17,-0.016441573693482092,36,5.169925001442312
throw,3,1,1,-0.015502055196711688,4,2.0
represents,5,2,1,-0.030886670581327075,6,2.584962500721156
light,5,2,20,0.11415149735760421,25,4.643856189774724
doing,8,6,5,-0.023429242513211983,13,3.700439718141092
irish,2,4,2,-0.00017615971814445228,4,2.0
happiness,0,1,2,0.015208455666470933,2,1.0
west,5,1,0,-0.038520258367586616,5,2.321928094887362
mother,4,28,6,0.014973576042278329,10,3.3219280948873626
events,1,8,4,0.022783323546682326,5,2.321928094887362
dramatic,8,4,6,-0.015795654726952442,14,3.8073549220576037
aboriginal,0,1,2,0.015208455666470933,2,1.0
beneath,2,1,6,0.030358191426893714,8,3.0
minimum,0,1,2,0.015208455666470933,2,1.0
rejected,1,2,0,-0.007751027598355844,1,0.0
clear,9,2,8,-0.008220786846741046,17,4.08746284125034
friend,5,11,3,-0.01561949500880799,8,3.0
match,6,2,3,-0.023311802701115682,9,3.1699250014423126
entitled,0,1,1,0.007574867880211391,1,0.0
fat,6,2,9,0.022489724016441573,15,3.9068905956085187
classic,15,2,11,-0.03147386964180858,26,4.700439718141093
sees,1,5,2,0.0075161479741632405,3,1.5849625007211563
preview,2,1,0,-0.015443335290663537,2,1.0
teen,14,5,7,-0.05431591309453906,21,4.392317422778761
muniz,1,1,1,-0.0001174398120963021,2,1.0
named,5,23,0,-0.038520258367586616,5,2.321928094887362
take,19,18,34,0.11332941867293012,53,5.7279204545632
frankie,1,1,0,-0.007751027598355844,1,0.0
important,3,4,8,0.03793305930710511,11,3.4594316186372978
turns,14,13,14,-0.0008807985907222649,28,4.807354922057604
fun,26,3,73,0.31902524955960065,99,6.6293566200796095
tale,18,10,21,0.021785085143863764,39,5.285402218862249
producer,2,7,3,0.0074574280681150885,5,2.321928094887362
jason,1,7,2,0.0075161479741632405,3,1.5849625007211563
loses,8,3,4,-0.031062830299471524,12,3.5849625007211565
liar,2,4,1,-0.007809747504403995,3,1.5849625007211563
using,8,4,2,-0.04633000587199061,10,3.3219280948873626
go,36,14,30,-0.047974163241338796,66,6.044394119358453
lies,0,2,4,0.03047563123899002,4,2.0
name,9,6,6,-0.023487962419260135,15,3.9068905956085187
big,54,15,52,-0.026071638285378784,106,6.727920454563199
los,0,3,3,0.022842043452730474,3,1.5849625007211563
summer,6,2,29,0.1751614797416324,35,5.129283016944966
best,36,9,108,0.39477392836171465,144,7.169925001442313
make,58,14,69,0.057721667645331765,127,6.988684686772166
hands,2,8,3,0.0074574280681150885,5,2.321928094887362
barry,3,4,3,-0.0002348796241926042,6,2.584962500721156
interests,0,2,1,0.007574867880211391,1,0.0
dave,0,2,1,0.007574867880211391,1,0.0
add,10,2,7,-0.023546682325308287,17,4.08746284125034
decide,1,8,0,-0.007751027598355844,1,0.0
winner,2,1,3,0.0074574280681150885,5,2.321928094887362
following,4,4,1,-0.023194362889019382,5,2.321928094887362
creative,5,4,13,0.06071638285378743,18,4.169925001442312
mysterious,0,7,1,0.007574867880211391,1,0.0
chase,9,5,3,-0.046388725778038764,12,3.5849625007211565
inspired,8,1,7,-0.008162066940692901,15,3.9068905956085187
case,6,10,6,-0.00041103934233705647,12,3.5849625007211565
dad,1,2,0,-0.007751027598355844,1,0.0
suitcase,0,1,1,0.007574867880211391,1,0.0
wild,13,5,4,-0.06952436876100998,17,4.08746284125034
same,32,11,17,-0.11644157369348207,49,5.614709844115208
airport,1,1,0,-0.007751027598355844,1,0.0
ends,14,4,8,-0.04668232530827951,22,4.459431618637297
constant,1,2,4,0.022783323546682326,5,2.321928094887362
lead,9,7,6,-0.023487962419260135,15,3.9068905956085187
comes,30,13,25,-0.039988256018790386,55,5.78135971352466
miami,2,3,1,-0.007809747504403995,3,1.5849625007211563
television,9,5,1,-0.061655901350557846,10,3.3219280948873626
goose,0,1,2,0.015208455666470933,2,1.0
chain,0,1,3,0.022842043452730474,3,1.5849625007211563
matt,1,10,0,-0.007751027598355844,1,0.0
complicated,3,2,4,0.00739870816206694,7,2.807354922057604
steal,1,1,2,0.0075161479741632405,3,1.5849625007211563
mind,13,6,19,0.044979448032883146,32,5.0
arnold,10,4,4,-0.04644744568408691,14,3.8073549220576037
arthur,1,3,0,-0.007751027598355844,1,0.0
tired,12,1,6,-0.04656488549618321,18,4.169925001442312
session,0,1,1,0.007574867880211391,1,0.0
feels,47,3,20,-0.20892542571931888,67,6.066089190457772
guilt,2,3,1,-0.007809747504403995,3,1.5849625007211563
mystery,14,5,6,-0.0619495008807986,20,4.321928094887363
full,29,7,28,-0.009395184967704057,57,5.832890014164742
death,10,21,9,-0.008279506752789198,19,4.247927513443585
attacks,1,1,1,-0.0001174398120963021,2,1.0
later,1,5,4,0.022783323546682326,5,2.321928094887362
strange,6,10,9,0.022489724016441573,15,3.9068905956085187
shadows,1,1,5,0.030416911332941866,6,2.584962500721156
guilty,7,1,7,-0.0004697592483852084,14,3.8073549220576037
dawn,1,5,0,-0.007751027598355844,1,0.0
now,16,25,14,-0.01626541397533765,30,4.906890595608519
goes,21,10,20,-0.008925425719318869,41,5.357552004618084
drunk,3,3,5,0.015032295948326481,8,3.0
girl,15,19,11,-0.03147386964180858,26,4.700439718141093
before,29,24,21,-0.06283029947152086,50,5.643856189774724
while,40,29,60,0.12736347621843808,100,6.643856189774725
haunted,6,2,2,-0.030945390487375223,8,3.0
crossed,3,3,0,-0.02313564298297123,3,1.5849625007211563
road,11,4,12,0.006928948913681732,23,4.523561956057013
walk,2,1,2,-0.00017615971814445228,4,2.0
ago,10,4,1,-0.06934820904286554,11,3.4594316186372978
deeper,2,2,6,0.030358191426893714,8,3.0
lost,12,2,6,-0.04656488549618321,18,4.169925001442312
sense,30,4,24,-0.04762184380504991,54,5.754887502163469
reached,2,1,0,-0.015443335290663537,2,1.0
looking,23,8,17,-0.04721080446271286,40,5.321928094887363
runs,5,3,6,0.007281268349970636,11,3.4594316186372978
caused,1,2,0,-0.007751027598355844,1,0.0
reality,9,7,8,-0.008220786846741046,17,4.08746284125034
struck,1,2,2,0.0075161479741632405,3,1.5849625007211563
car,13,7,3,-0.07715795654726954,16,4.0
altered,1,4,0,-0.007751027598355844,1,0.0
encounters,0,3,1,0.007574867880211391,1,0.0
years,14,25,20,0.04492072812683498,34,5.08746284125034
tie,2,2,0,-0.015443335290663537,2,1.0
drive,1,2,2,0.0075161479741632405,3,1.5849625007211563
recently,1,1,1,-0.0001174398120963021,2,1.0
actually,19,5,20,0.006459189665296516,39,5.285402218862249
heart,11,7,45,0.2588373458602466,56,5.807354922057605
eastwood,7,1,6,-0.00810334703464475,13,3.700439718141092
staged,7,1,1,-0.04627128596594246,8,3.0
spend,5,2,7,0.014914856136230177,12,3.5849625007211565
endurance,1,1,0,-0.007751027598355844,1,0.0
feeble,1,1,0,-0.007751027598355844,1,0.0
harbor,1,3,0,-0.007751027598355844,1,0.0
jesus,1,1,0,-0.007751027598355844,1,0.0
given,8,5,9,0.0071051086318261875,17,4.08746284125034
boat,4,2,0,-0.030827950675278923,4,2.0
muster,1,1,0,-0.007751027598355844,1,0.0
killer,4,8,3,-0.007927187316500297,7,2.807354922057604
terry,1,3,2,0.0075161479741632405,3,1.5849625007211563
serial,1,3,1,-0.0001174398120963021,2,1.0
living,5,10,8,0.022548443922489725,13,3.700439718141092
random,4,1,2,-0.015560775102759838,6,2.584962500721156
nap,1,1,0,-0.007751027598355844,1,0.0
look,32,3,42,0.07439812096300646,74,6.209453365628951
happens,9,4,3,-0.046388725778038764,12,3.5849625007211565
robbery,1,1,0,-0.007751027598355844,1,0.0
intended,2,1,5,0.022724603640634174,7,2.807354922057604
upon,5,4,10,0.037815619495008806,15,3.9068905956085187
killing,1,5,2,0.0075161479741632405,3,1.5849625007211563
derry,0,1,1,0.007574867880211391,1,0.0
documentary,7,3,19,0.0911332941867293,26,4.700439718141093
march,0,1,2,0.015208455666470933,2,1.0
tragic,3,2,4,0.00739870816206694,7,2.807354922057604
30,3,6,1,-0.015502055196711688,4,2.0
rights,1,1,0,-0.007751027598355844,1,0.0
wounding,0,1,1,0.007574867880211391,1,0.0
january,1,1,2,0.0075161479741632405,3,1.5849625007211563
showing,0,1,1,0.007574867880211391,1,0.0
13,2,1,0,-0.015443335290663537,2,1.0
troops,0,1,1,0.007574867880211391,1,0.0
northern,0,1,1,0.007574867880211391,1,0.0
1972,0,1,1,0.007574867880211391,1,0.0
ireland,0,1,3,0.022842043452730474,3,1.5849625007211563
style,13,3,21,0.06024662360540223,34,5.08746284125034
town,2,12,3,0.0074574280681150885,5,2.321928094887362
until,13,19,10,-0.023722842043452735,23,4.523561956057013
every,58,7,41,-0.11785085143863772,99,6.6293566200796095
balance,3,2,6,0.022665883734586022,9,3.1699250014423126
competition,1,1,3,0.015149735760422781,4,2.0
count,3,4,4,0.00739870816206694,7,2.807354922057604
conquer,0,1,1,0.007574867880211391,1,0.0
transplanted,1,1,0,-0.007751027598355844,1,0.0
three,11,16,10,-0.00833822665883735,21,4.392317422778761
rebellious,1,2,0,-0.007751027598355844,1,0.0
surf,1,2,2,0.0075161479741632405,3,1.5849625007211563
charged,3,1,2,-0.007868467410452145,5,2.321928094887362
finding,1,3,6,0.03805049911920141,7,2.807354922057604
waves,0,1,4,0.03047563123899002,4,2.0
morning,1,1,3,0.015149735760422781,4,2.0
adrenaline,0,2,1,0.007574867880211391,1,0.0
own,39,20,44,0.0358191426893717,83,6.375039431346925
along,11,4,21,0.07563123899001761,32,5.0
losing,2,2,2,-0.00017615971814445228,4,2.0
beach,2,4,1,-0.007809747504403995,3,1.5849625007211563
board,1,2,0,-0.007751027598355844,1,0.0
younger,3,3,4,0.00739870816206694,7,2.807354922057604
anne,1,3,0,-0.007751027598355844,1,0.0
pro,2,1,1,-0.007809747504403995,3,1.5849625007211563
herself,2,7,5,0.022724603640634174,7,2.807354922057604
including,5,9,3,-0.01561949500880799,8,3.0
falls,17,8,8,-0.06975924838520259,25,4.643856189774724
scene,15,5,14,-0.008573106283029958,29,4.857980995127573
violence,11,4,8,-0.02360540223135643,19,4.247927513443585
political,2,5,8,0.0456253669994128,10,3.3219280948873626
notorious,0,2,1,0.007574867880211391,1,0.0
conventional,5,2,7,0.014914856136230177,12,3.5849625007211565
national,3,1,2,-0.007868467410452145,5,2.321928094887362
roots,1,1,0,-0.007751027598355844,1,0.0
history,7,6,14,0.052965355255431584,21,4.392317422778761
seeks,0,2,1,0.007574867880211391,1,0.0
moore,1,4,19,0.13728714034057546,20,4.321928094887363
without,33,6,41,0.05907222548443919,74,6.209453365628951
entertainment,17,1,30,0.09817968291250734,47,5.554588851677638
sets,3,6,9,0.04556664709336465,12,3.5849625007211565
explanation,3,1,0,-0.02313564298297123,3,1.5849625007211563
corporate,2,2,4,0.015091015854374633,6,2.584962500721156
examination,2,1,7,0.037991779213153255,9,3.1699250014423126
cultures,0,1,2,0.015208455666470933,2,1.0
takes,27,15,19,-0.06271285965942455,46,5.523561956057013
gun,2,2,3,0.0074574280681150885,5,2.321928094887362
culture,1,4,15,0.10675278919553728,16,4.0
angry,1,1,2,0.0075161479741632405,3,1.5849625007211563
poverty,0,1,2,0.015208455666470933,2,1.0
answers,0,2,5,0.03810921902524956,5,2.321928094887362
number,5,2,8,0.022548443922489725,13,3.700439718141092
other,48,19,32,-0.12501467997651206,80,6.321928094887362
equivalent,8,1,0,-0.061597181444509694,8,3.0
those,30,8,49,0.14321785085143865,79,6.303780748177103
states,1,3,0,-0.007751027598355844,1,0.0
america,6,4,13,0.053024075161479736,19,4.247927513443585
filmmaker,0,2,10,0.07627715795654727,10,3.3219280948873626
arrive,2,1,1,-0.007809747504403995,3,1.5849625007211563
explore,1,1,1,-0.0001174398120963021,2,1.0
powerful,2,2,19,0.12959483264826777,21,4.392317422778761
easy,12,3,10,-0.016030534351145043,22,4.459431618637297
gain,1,2,1,-0.0001174398120963021,2,1.0
its,301,11,314,0.000998238402818541,615,9.264442600226602
learns,1,8,1,-0.0001174398120963021,2,1.0
bloodshed,0,1,1,0.007574867880211391,1,0.0
guns,4,1,3,-0.007927187316500297,7,2.807354922057604
humour,4,1,2,-0.015560775102759838,6,2.584962500721156
lathan,0,2,4,0.03047563123899002,4,2.0
l,2,2,1,-0.007809747504403995,3,1.5849625007211563
plays,18,8,7,-0.08508514386376984,25,4.643856189774724
diggs,1,1,4,0.022783323546682326,5,2.321928094887362
basketball,3,5,1,-0.015502055196711688,4,2.0
editor,1,1,0,-0.007751027598355844,1,0.0
claims,1,1,0,-0.007751027598355844,1,0.0
ve,38,2,32,-0.04809160305343513,70,6.129283016944967
executive,1,2,0,-0.007751027598355844,1,0.0
times,16,1,19,0.021902524955960068,35,5.129283016944966
talented,7,2,8,0.007163828537874339,15,3.9068905956085187
known,0,11,4,0.03047563123899002,4,2.0
writer,20,4,19,-0.008866705813270703,39,5.285402218862249
focus,7,2,7,-0.0004697592483852084,14,3.8073549220576037
perfect,4,11,19,0.11421021726365238,23,4.523561956057013
interested,3,1,4,0.00739870816206694,7,2.807354922057604
company,7,7,12,0.0376981796829125,19,4.247927513443585
centers,1,2,0,-0.007751027598355844,1,0.0
amp,3,4,10,0.05320023487962419,13,3.700439718141092
music,14,5,34,0.15179095713446858,48,5.584962500721157
reese,3,1,1,-0.015502055196711688,4,2.0
being,34,17,32,-0.017322372284204357,66,6.044394119358453
artistry,0,1,3,0.022842043452730474,3,1.5849625007211563
harry,4,14,13,0.06840869054609512,17,4.08746284125034
increasingly,2,2,0,-0.015443335290663537,2,1.0
player,2,1,1,-0.007809747504403995,3,1.5849625007211563
left,21,7,6,-0.11579565472695244,27,4.754887502163469
meanwhile,1,6,0,-0.007751027598355844,1,0.0
review,2,1,0,-0.015443335290663537,2,1.0
each,13,10,14,0.006811509101585428,27,4.754887502163469
record,1,5,4,0.022783323546682326,5,2.321928094887362
children,12,13,19,0.05267175572519084,31,4.954196310386876
since,19,9,22,0.021726365237815598,41,5.357552004618084
restless,1,2,0,-0.007751027598355844,1,0.0
engaged,2,3,3,0.0074574280681150885,5,2.321928094887362
r,3,5,1,-0.015502055196711688,4,2.0
latifah,0,1,2,0.015208455666470933,2,1.0
growing,2,4,6,0.030358191426893714,8,3.0
hop,6,4,1,-0.03857897827363477,7,2.807354922057604
towards,3,3,1,-0.015502055196711688,4,2.0
romantic,29,5,32,0.02113916617733408,61,5.930737337562887
both,19,8,52,0.23546682325308277,71,6.149747119504682
handsome,2,5,2,-0.00017615971814445228,4,2.0
leads,3,10,7,0.030299471520845563,10,3.3219280948873626
gimmicky,1,1,0,-0.007751027598355844,1,0.0
ten,3,2,0,-0.02313564298297123,3,1.5849625007211563
themselves,5,9,9,0.030182031708749266,14,3.8073549220576037
re,46,10,49,0.020140927774515593,95,6.569855608330948
profit,1,1,0,-0.007751027598355844,1,0.0
romance,13,3,17,0.029712272460364064,30,4.906890595608519
lawyer,1,7,0,-0.007751027598355844,1,0.0
except,12,3,0,-0.09236641221374046,12,3.5849625007211565
ignoring,1,1,0,-0.007751027598355844,1,0.0
described,2,1,0,-0.015443335290663537,2,1.0
marry,1,1,1,-0.0001174398120963021,2,1.0
label,1,1,1,-0.0001174398120963021,2,1.0
battle,7,12,11,0.030064591896652962,18,4.169925001442312
chosen,2,1,1,-0.007809747504403995,3,1.5849625007211563
texas,1,3,1,-0.0001174398120963021,2,1.0
missed,6,1,2,-0.030945390487375223,8,3.0
author,1,2,1,-0.0001174398120963021,2,1.0
rest,7,6,5,-0.01573693482090429,12,3.5849625007211565
f,1,1,2,0.0075161479741632405,3,1.5849625007211563
chance,3,5,6,0.022665883734586022,9,3.1699250014423126
award,0,1,3,0.022842043452730474,3,1.5849625007211563
elvis,0,5,1,0.007574867880211391,1,0.0
forth,0,1,1,0.007574867880211391,1,0.0
teams,1,3,0,-0.007751027598355844,1,0.0
tep,0,1,2,0.015208455666470933,2,1.0
did,15,1,5,-0.07727539635936584,20,4.321928094887363
really,68,4,37,-0.20992366412213742,105,6.714245517666122
ho,1,1,2,0.0075161479741632405,3,1.5849625007211563
valiant,0,1,1,0.007574867880211391,1,0.0
resident,5,2,1,-0.030886670581327075,6,2.584962500721156
hunting,1,1,0,-0.007751027598355844,1,0.0
campbell,0,2,4,0.03047563123899002,4,2.0
term,1,2,1,-0.0001174398120963021,2,1.0
cult,1,1,2,0.0075161479741632405,3,1.5849625007211563
east,1,3,0,-0.007751027598355844,1,0.0
jack,2,3,5,0.022724603640634174,7,2.807354922057604
thinks,5,7,1,-0.030886670581327075,6,2.584962500721156
entity,1,2,0,-0.007751027598355844,1,0.0
happy,2,3,9,0.053258954785672344,11,3.4594316186372978
bruce,4,1,5,0.007339988256018788,9,3.1699250014423126
joe,5,4,2,-0.02325308279506753,7,2.807354922057604
bubba,0,1,2,0.015208455666470933,2,1.0
2,10,3,15,0.03752201996476805,25,4.643856189774724
catches,2,1,0,-0.015443335290663537,2,1.0
pilot,3,2,0,-0.02313564298297123,3,1.5849625007211563
tracks,1,4,0,-0.007751027598355844,1,0.0
general,4,1,4,-0.00029359953024075264,8,3.0
5,3,1,3,-0.0002348796241926042,6,2.584962500721156
million,4,7,0,-0.030827950675278923,4,2.0
successfully,0,1,4,0.03047563123899002,4,2.0
26,0,1,2,0.015208455666470933,2,1.0
artist,1,2,9,0.06095126247798004,10,3.3219280948873626
profanity,1,1,1,-0.0001174398120963021,2,1.0
questionable,3,1,1,-0.015502055196711688,4,2.0
samuel,0,2,1,0.007574867880211391,1,0.0
ethical,0,1,2,0.015208455666470933,2,1.0
court,2,7,1,-0.007809747504403995,3,1.5849625007211563
discussion,0,1,2,0.015208455666470933,2,1.0
mild,3,1,1,-0.015502055196711688,4,2.0
crash,3,2,0,-0.02313564298297123,3,1.5849625007211563
jackson,3,3,3,-0.0002348796241926042,6,2.584962500721156
gives,8,3,26,0.1368761009982384,34,5.08746284125034
mouse,1,2,4,0.022783323546682326,5,2.321928094887362
questioning,0,1,2,0.015208455666470933,2,1.0
legal,1,4,2,0.0075161479741632405,3,1.5849625007211563
directions,2,1,0,-0.015443335290663537,2,1.0
end,36,11,32,-0.03270698766881974,68,6.08746284125034
thus,1,1,1,-0.0001174398120963021,2,1.0
trust,1,2,2,0.0075161479741632405,3,1.5849625007211563
contains,2,1,1,-0.007809747504403995,3,1.5849625007211563
actions,1,5,0,-0.007751027598355844,1,0.0
game,14,8,9,-0.03904873752201997,23,4.523561956057013
dollar,1,1,0,-0.007751027598355844,1,0.0
part,5,12,17,0.0912507339988256,22,4.459431618637297
insurance,2,2,2,-0.00017615971814445228,4,2.0
involving,5,3,7,0.014914856136230177,12,3.5849625007211565
post,2,2,5,0.022724603640634174,7,2.807354922057604
appear,1,3,2,0.0075161479741632405,3,1.5849625007211563
moral,5,1,10,0.037815619495008806,15,3.9068905956085187
multi,1,1,1,-0.0001174398120963021,2,1.0
present,3,5,3,-0.0002348796241926042,6,2.584962500721156
few,38,5,29,-0.07099236641221374,67,6.066089190457772
drops,0,1,1,0.007574867880211391,1,0.0
strands,1,1,0,-0.007751027598355844,1,0.0
parties,1,1,0,-0.007751027598355844,1,0.0
miss,11,2,7,-0.03123899001761598,18,4.169925001442312
understanding,0,2,1,0.007574867880211391,1,0.0
cat,1,2,6,0.03805049911920141,7,2.807354922057604
affleck,2,1,1,-0.007809747504403995,3,1.5849625007211563
rush,3,2,3,-0.0002348796241926042,6,2.584962500721156
issues,4,2,11,0.05314151497357604,15,3.9068905956085187
shake,3,1,3,-0.0002348796241926042,6,2.584962500721156
altering,1,2,1,-0.0001174398120963021,2,1.0
sam,2,9,4,0.015091015854374633,6,2.584962500721156
spontaneous,0,1,1,0.007574867880211391,1,0.0
smooth,0,2,2,0.015208455666470933,2,1.0
roberts,3,2,0,-0.02313564298297123,3,1.5849625007211563
isn,66,3,37,-0.19453904873752204,103,6.6865005271832185
walks,0,2,2,0.015208455666470933,2,1.0
loves,1,2,0,-0.007751027598355844,1,0.0
charly,1,4,0,-0.007751027598355844,1,0.0
lake,0,1,1,0.007574867880211391,1,0.0
things,27,12,18,-0.07034644744568411,45,5.491853096329675
idealism,0,1,1,0.007574867880211391,1,0.0
vibrance,0,1,1,0.007574867880211391,1,0.0
thrown,4,1,1,-0.023194362889019382,5,2.321928094887362
depth,7,1,8,0.007163828537874339,15,3.9068905956085187
challenges,0,1,4,0.03047563123899002,4,2.0
cultural,1,2,6,0.03805049911920141,7,2.807354922057604
interest,11,1,6,-0.03887257780387552,17,4.08746284125034
different,6,5,8,0.014856136230182032,14,3.8073549220576037
former,5,5,1,-0.030886670581327075,6,2.584962500721156
spark,3,1,0,-0.02313564298297123,3,1.5849625007211563
though,33,6,39,0.043805049911920135,72,6.169925001442312
cynical,5,2,2,-0.02325308279506753,7,2.807354922057604
meaning,4,3,5,0.007339988256018788,9,3.1699250014423126
purpose,5,3,3,-0.01561949500880799,8,3.0
relationship,1,8,5,0.030416911332941866,6,2.584962500721156
salt,2,1,1,-0.007809747504403995,3,1.5849625007211563
hours,12,6,4,-0.061832061068702295,16,4.0
80s,1,1,1,-0.0001174398120963021,2,1.0
prove,2,2,4,0.015091015854374633,6,2.584962500721156
spends,1,3,0,-0.007751027598355844,1,0.0
unfairly,1,1,0,-0.007751027598355844,1,0.0
officer,1,4,0,-0.007751027598355844,1,0.0
something,47,8,49,0.012448620082207873,96,6.584962500721156
frequent,1,1,2,0.0075161479741632405,3,1.5849625007211563
hit,9,12,17,0.060481503229594835,26,4.700439718141093
arrest,1,2,0,-0.007751027598355844,1,0.0
regain,1,2,0,-0.007751027598355844,1,0.0
twenty,5,2,1,-0.030886670581327075,6,2.584962500721156
charge,0,2,1,0.007574867880211391,1,0.0
pop,9,1,11,0.014679976512037576,20,4.321928094887363
house,9,13,2,-0.054022313564298305,11,3.4594316186372978
homicide,1,3,0,-0.007751027598355844,1,0.0
trial,0,6,1,0.007574867880211391,1,0.0
songs,4,2,7,0.02260716382853787,11,3.4594316186372978
falling,1,6,3,0.015149735760422781,4,2.0
fantasy,4,1,12,0.06077510275983558,16,4.0
mushy,3,1,0,-0.02313564298297123,3,1.5849625007211563
countless,1,2,0,-0.007751027598355844,1,0.0
san,0,1,1,0.007574867880211391,1,0.0
listening,1,1,1,-0.0001174398120963021,2,1.0
syrupy,0,1,1,0.007574867880211391,1,0.0
cherish,3,1,5,0.015032295948326481,8,3.0
facing,0,1,3,0.022842043452730474,3,1.5849625007211563
confined,1,1,1,-0.0001174398120963021,2,1.0
freedom,0,1,4,0.03047563123899002,4,2.0
innocence,1,3,2,0.0075161479741632405,3,1.5849625007211563
zoe,1,3,0,-0.007751027598355844,1,0.0
mix,4,1,5,0.007339988256018788,9,3.1699250014423126
vaudeville,2,1,2,-0.00017615971814445228,4,2.0
career,10,10,8,-0.01591309453904874,18,4.169925001442312
seductive,0,2,1,0.007574867880211391,1,0.0
chorus,0,1,1,0.007574867880211391,1,0.0
affair,4,6,0,-0.030827950675278923,4,2.0
velma,1,13,1,-0.0001174398120963021,2,1.0
slick,6,1,3,-0.023311802701115682,9,3.1699250014423126
shoots,0,3,1,0.007574867880211391,1,0.0
club,3,1,0,-0.02313564298297123,3,1.5849625007211563
due,0,3,3,0.022842043452730474,3,1.5849625007211563
rejection,0,1,1,0.007574867880211391,1,0.0
hungry,1,3,1,-0.0001174398120963021,2,1.0
trick,5,1,4,-0.007985907222548445,9,3.1699250014423126
lucky,1,1,2,0.0075161479741632405,3,1.5849625007211563
off,58,17,42,-0.11021726365237816,100,6.643856189774725
press,0,2,1,0.007574867880211391,1,0.0
cell,2,1,1,-0.007809747504403995,3,1.5849625007211563
arrives,4,3,2,-0.015560775102759838,6,2.584962500721156
offers,10,3,18,0.06042278332354667,28,4.807354922057604
nights,1,2,0,-0.007751027598355844,1,0.0
forget,4,1,5,0.007339988256018788,9,3.1699250014423126
only,100,32,43,-0.2948913681738109,143,7.159871336778389
news,2,1,0,-0.015443335290663537,2,1.0
good,85,5,133,0.14820904286553138,218,7.768184324776926
flat,16,1,4,-0.09260129183793306,20,4.321928094887363
play,6,6,13,0.053024075161479736,19,4.247927513443585
block,1,3,2,0.0075161479741632405,3,1.5849625007211563
stardom,1,1,0,-0.007751027598355844,1,0.0
opportunity,5,1,5,-0.00035231943628890455,10,3.3219280948873626
these,25,8,25,-0.001526717557251922,50,5.643856189774724
offer,11,4,3,-0.06177334116265415,14,3.8073549220576037
able,4,5,9,0.03787433940105696,13,3.700439718141092
thinking,7,3,9,0.01479741632413388,16,4.0
fell,1,2,0,-0.007751027598355844,1,0.0
sharing,1,1,0,-0.007751027598355844,1,0.0
if,140,11,141,0.04045801526717563,281,8.134426320220927
hapless,2,1,0,-0.015443335290663537,2,1.0
ready,3,4,1,-0.015502055196711688,4,2.0
warm,1,2,11,0.07621843805049912,12,3.5849625007211565
shared,0,3,2,0.015208455666470933,2,1.0
casting,3,1,7,0.030299471520845563,10,3.3219280948873626
gap,1,1,0,-0.007751027598355844,1,0.0
blame,2,1,1,-0.007809747504403995,3,1.5849625007211563
refuses,4,3,2,-0.015560775102759838,6,2.584962500721156
were,50,13,14,-0.2701115678214915,64,6.0
dreams,1,6,4,0.022783323546682326,5,2.321928094887362
lights,1,2,1,-0.0001174398120963021,2,1.0
receiving,0,1,1,0.007574867880211391,1,0.0
p,2,3,3,0.0074574280681150885,5,2.321928094887362
continually,0,1,2,0.015208455666470933,2,1.0
ultimate,4,4,8,0.030240751614797418,12,3.5849625007211565
awe,3,1,1,-0.015502055196711688,4,2.0
onto,5,2,1,-0.030886670581327075,6,2.584962500721156
found,6,6,10,0.030123311802701114,16,4.0
tabloid,2,2,0,-0.015443335290663537,2,1.0
ll,29,3,37,0.0593071051086318,66,6.044394119358453
bill,1,1,0,-0.007751027598355844,1,0.0
sob,0,1,1,0.007574867880211391,1,0.0
boring,17,1,0,-0.13082795067527891,17,4.08746284125034
fred,1,5,0,-0.007751027598355844,1,0.0
collection,9,1,0,-0.06928948913681739,9,3.1699250014423126
earlier,4,2,4,-0.00029359953024075264,8,3.0
mrs,1,2,0,-0.007751027598355844,1,0.0
break,3,4,6,0.022665883734586022,9,3.1699250014423126
media,2,5,2,-0.00017615971814445228,4,2.0
connections,1,1,1,-0.0001174398120963021,2,1.0
infidelity,0,1,2,0.015208455666470933,2,1.0
wrong,16,5,6,-0.07733411626541398,22,4.459431618637297
attention,5,5,10,0.037815619495008806,15,3.9068905956085187
forgotten,4,1,7,0.02260716382853787,11,3.4594316186372978
stage,2,1,5,0.022724603640634174,7,2.807354922057604
top,13,9,16,0.02207868467410451,29,4.857980995127573
committed,2,2,2,-0.00017615971814445228,4,2.0
hanging,1,1,2,0.0075161479741632405,3,1.5849625007211563
path,2,2,5,0.022724603640634174,7,2.807354922057604
took,2,5,2,-0.00017615971814445228,4,2.0
walked,4,1,0,-0.030827950675278923,4,2.0
billy,3,4,1,-0.015502055196711688,4,2.0
tabloids,1,2,0,-0.007751027598355844,1,0.0
topping,1,1,0,-0.007751027598355844,1,0.0
huge,2,3,5,0.022724603640634174,7,2.807354922057604
watches,1,3,1,-0.0001174398120963021,2,1.0
double,3,3,3,-0.0002348796241926042,6,2.584962500721156
anger,1,2,3,0.015149735760422781,4,2.0
kills,1,4,0,-0.007751027598355844,1,0.0
bring,4,6,7,0.02260716382853787,11,3.4594316186372978
multiple,1,1,2,0.0075161479741632405,3,1.5849625007211563
convinces,1,2,0,-0.007751027598355844,1,0.0
hoping,1,2,2,0.0075161479741632405,3,1.5849625007211563
sly,0,1,8,0.06100998238402819,8,3.0
husband,2,18,2,-0.00017615971814445228,4,2.0
filling,1,1,2,0.0075161479741632405,3,1.5849625007211563
darling,0,1,1,0.007574867880211391,1,0.0
flee,0,1,2,0.015208455666470933,2,1.0
partners,1,2,2,0.0075161479741632405,3,1.5849625007211563
roxie,0,20,2,0.015208455666470933,2,1.0
you,280,6,308,-0.0065766294773929035,588,9.199672344836365
bright,6,2,5,-0.008044627128596597,11,3.4594316186372978
hell,5,1,8,0.022548443922489725,13,3.700439718141092
hart,3,5,2,-0.007868467410452145,5,2.321928094887362
girls,1,5,5,0.030416911332941866,6,2.584962500721156
crazy,4,2,4,-0.00029359953024075264,8,3.0
way,57,14,87,0.17228420434527303,144,7.169925001442313
singer,4,1,1,-0.023194362889019382,5,2.321928094887362
couch,0,1,1,0.007574867880211391,1,0.0
innocent,2,8,0,-0.015443335290663537,2,1.0
final,13,5,8,-0.03899001761597182,21,4.392317422778761
gritty,2,1,2,-0.00017615971814445228,4,2.0
treatment,7,1,4,-0.02337052260716383,11,3.4594316186372978
wicked,0,1,1,0.007574867880211391,1,0.0
aloof,1,1,2,0.0075161479741632405,3,1.5849625007211563
manages,9,2,24,0.11391661773341163,33,5.044394119358453
matron,0,1,1,0.007574867880211391,1,0.0
approach,7,1,7,-0.0004697592483852084,14,3.8073549220576037
do,52,6,36,-0.11755725190839694,88,6.459431618637298
support,4,1,3,-0.007927187316500297,7,2.807354922057604
sorrow,0,1,2,0.015208455666470933,2,1.0
broken,2,4,2,-0.00017615971814445228,4,2.0
influenced,0,1,1,0.007574867880211391,1,0.0
enforcement,0,1,1,0.007574867880211391,1,0.0
self,26,9,28,0.013681738109219022,54,5.754887502163469
latest,10,1,5,-0.03881385789782737,15,3.9068905956085187
follow,2,3,5,0.022724603640634174,7,2.807354922057604
anonymity,0,1,1,0.007574867880211391,1,0.0
destructive,0,1,1,0.007574867880211391,1,0.0
still,26,11,63,0.25795654726952433,89,6.475733430966398
sure,9,1,15,0.04521432765707574,24,4.584962500721157
suspect,1,2,1,-0.0001174398120963021,2,1.0
convicted,1,1,0,-0.007751027598355844,1,0.0
drawing,0,2,3,0.022842043452730474,3,1.5849625007211563
deeply,4,2,13,0.06840869054609512,17,4.08746284125034
door,1,1,2,0.0075161479741632405,3,1.5849625007211563
intensely,1,1,2,0.0075161479741632405,3,1.5849625007211563
painfully,7,1,2,-0.03863769817968292,9,3.1699250014423126
course,8,3,7,-0.008162066940692901,15,3.9068905956085187
unresolved,0,1,1,0.007574867880211391,1,0.0
pain,4,2,3,-0.007927187316500297,7,2.807354922057604
waiting,5,3,3,-0.01561949500880799,8,3.0
length,12,2,5,-0.054198473282442754,17,4.08746284125034
forged,1,1,0,-0.007751027598355844,1,0.0
keeping,3,4,3,-0.0002348796241926042,6,2.584962500721156
executed,3,1,0,-0.02313564298297123,3,1.5849625007211563
distinguished,1,1,2,0.0075161479741632405,3,1.5849625007211563
tortured,1,1,3,0.015149735760422781,4,2.0
manhattan,3,5,6,0.022665883734586022,9,3.1699250014423126
precinct,0,1,1,0.007574867880211391,1,0.0
higher,1,1,6,0.03805049911920141,7,2.807354922057604
return,3,7,3,-0.0002348796241926042,6,2.584962500721156
makes,52,9,56,0.019847328244274764,108,6.754887502163469
vincent,0,7,1,0.007574867880211391,1,0.0
been,79,20,54,-0.1569583088667058,133,7.05528243550119
island,5,5,3,-0.01561949500880799,8,3.0
work,52,13,70,0.1038167938931297,122,6.930737337562887
maintains,0,1,3,0.022842043452730474,3,1.5849625007211563
successful,3,4,8,0.03793305930710511,11,3.4594316186372978
agonizing,2,1,0,-0.015443335290663537,2,1.0
law,1,6,2,0.0075161479741632405,3,1.5849625007211563
stakes,0,1,1,0.007574867880211391,1,0.0
greatest,1,2,4,0.022783323546682326,5,2.321928094887362
hypertime,2,1,0,-0.015443335290663537,2,1.0
seemingly,6,4,0,-0.04621256605989431,6,2.584962500721156
inventions,0,1,1,0.007574867880211391,1,0.0
quickly,14,6,4,-0.07721667645331767,18,4.169925001442312
beautiful,3,7,6,0.022665883734586022,9,3.1699250014423126
around,17,8,21,0.029477392836171457,38,5.247927513443585
stop,6,4,3,-0.023311802701115682,9,3.1699250014423126
various,7,2,0,-0.053904873752202,7,2.807354922057604
buy,3,2,2,-0.007868467410452145,5,2.321928094887362
amidst,1,1,3,0.015149735760422781,4,2.0
everything,23,10,13,-0.07774515560775104,36,5.169925001442312
frozen,1,1,0,-0.007751027598355844,1,0.0
realize,3,4,4,0.00739870816206694,7,2.807354922057604
quick,5,3,3,-0.01561949500880799,8,3.0
responsible,1,2,1,-0.0001174398120963021,2,1.0
might,51,7,30,-0.1556664709336465,81,6.339850002884625
justice,2,9,2,-0.00017615971814445228,4,2.0
international,1,1,1,-0.0001174398120963021,2,1.0
terrorism,1,1,2,0.0075161479741632405,3,1.5849625007211563
ultimately,29,6,15,-0.10863182618907812,44,5.459431618637297
thought,12,4,19,0.05267175572519084,31,4.954196310386876
bombing,0,1,1,0.007574867880211391,1,0.0
credited,1,1,0,-0.007751027598355844,1,0.0
matters,1,2,1,-0.0001174398120963021,2,1.0
frustrated,1,2,1,-0.0001174398120963021,2,1.0
dangerous,2,5,5,0.022724603640634174,7,2.807354922057604
murdering,1,1,0,-0.007751027598355844,1,0.0
night,10,10,10,-0.0006459189665296572,20,4.321928094887363
happened,3,2,2,-0.007868467410452145,5,2.321928094887362
operative,1,1,0,-0.007751027598355844,1,0.0
famous,1,9,1,-0.0001174398120963021,2,1.0
tv,23,7,6,-0.13118027011156783,29,4.857980995127573
confessions,1,1,6,0.03805049911920141,7,2.807354922057604
said,7,2,3,-0.031004110393423375,10,3.3219280948873626
screen,34,4,33,-0.009688784497944802,67,6.066089190457772
biggest,4,5,1,-0.023194362889019382,5,2.321928094887362
chuck,1,1,2,0.0075161479741632405,3,1.5849625007211563
made,60,6,48,-0.07980035231943627,108,6.754887502163469
hits,6,3,6,-0.00041103934233705647,12,3.5849625007211565
barris,0,2,5,0.03810921902524956,5,2.321928094887362
turn,4,4,11,0.05314151497357604,15,3.9068905956085187
folksy,1,1,0,-0.007751027598355844,1,0.0
hospital,1,5,1,-0.0001174398120963021,2,1.0
cure,1,1,0,-0.007751027598355844,1,0.0
adams,3,1,1,-0.015502055196711688,4,2.0
seeking,2,4,4,0.015091015854374633,6,2.584962500721156
state,4,4,10,0.0455079271873165,14,3.8073549220576037
calls,0,2,3,0.022842043452730474,3,1.5849625007211563
patient,1,1,1,-0.0001174398120963021,2,1.0
britney,11,1,1,-0.07704051673517323,12,3.5849625007211565
brings,4,4,7,0.02260716382853787,11,3.4594316186372978
spears,8,1,0,-0.061597181444509694,8,3.0
la,8,1,16,0.06054022313564297,24,4.584962500721157
going,22,10,17,-0.03951849677040517,39,5.285402218862249
queen,2,1,3,0.0074574280681150885,5,2.321928094887362
live,10,6,15,0.03752201996476805,25,4.643856189774724
change,7,6,10,0.02243100411039342,17,4.08746284125034
pregnant,1,3,0,-0.007751027598355844,1,0.0
reach,4,2,2,-0.015560775102759838,6,2.584962500721156
box,3,2,2,-0.007868467410452145,5,2.321928094887362
contract,1,1,0,-0.007751027598355844,1,0.0
strike,1,3,5,0.030416911332941866,6,2.584962500721156
pact,1,1,0,-0.007751027598355844,1,0.0
maniac,1,1,1,-0.0001174398120963021,2,1.0
topic,1,1,2,0.0075161479741632405,3,1.5849625007211563
little,79,11,60,-0.11879036993540809,139,7.118941072723508
midnight,1,1,1,-0.0001174398120963021,2,1.0
high,27,13,27,-0.0016441573693482259,54,5.754887502163469
graduation,0,2,1,0.007574867880211391,1,0.0
scared,1,3,2,0.0075161479741632405,3,1.5849625007211563
stays,1,1,5,0.030416911332941866,6,2.584962500721156
conversation,0,1,2,0.015208455666470933,2,1.0
vietnam,0,5,4,0.03047563123899002,4,2.0
ending,23,2,15,-0.06247798003523196,38,5.247927513443585
decades,2,2,2,-0.00017615971814445228,4,2.0
riveting,0,1,12,0.09154433352906635,12,3.5849625007211565
personal,6,6,15,0.06829125073399882,21,4.392317422778761
unlike,0,1,8,0.06100998238402819,8,3.0
separation,0,1,1,0.007574867880211391,1,0.0
always,5,2,22,0.1294186729301233,27,4.754887502163469
spans,0,1,1,0.007574867880211391,1,0.0
joyful,0,1,2,0.015208455666470933,2,1.0
unfolds,2,1,2,-0.00017615971814445228,4,2.0
thousands,0,1,1,0.007574867880211391,1,0.0
tennessee,1,2,1,-0.0001174398120963021,2,1.0
reunion,1,2,3,0.015149735760422781,4,2.0
most,68,10,106,0.1717557251908397,174,7.442943495848729
mai,0,2,1,0.007574867880211391,1,0.0
cliché,10,1,2,-0.061714621256606,12,3.5849625007211565
thi,0,2,1,0.007574867880211391,1,0.0
distance,1,2,2,0.0075161479741632405,3,1.5849625007211563
heidi,1,2,1,-0.0001174398120963021,2,1.0
climax,2,1,1,-0.007809747504403995,3,1.5849625007211563
kids,25,7,37,0.09007633587786257,62,5.954196310386876
22,1,1,0,-0.007751027598355844,1,0.0
longing,1,1,2,0.0075161479741632405,3,1.5849625007211563
vietnamese,0,2,2,0.015208455666470933,2,1.0
danang,0,3,4,0.03047563123899002,4,2.0
kim,0,1,1,0.007574867880211391,1,0.0
orphans,0,1,2,0.015208455666470933,2,1.0
rainbow,0,1,1,0.007574867880211391,1,0.0
insane,0,1,3,0.022842043452730474,3,1.5849625007211563
getting,13,6,13,-0.0008220786846741129,26,4.700439718141093
proud,0,2,5,0.03810921902524956,5,2.321928094887362
smoochy,6,4,2,-0.030945390487375223,8,3.0
disgrace,0,1,1,0.007574867880211391,1,0.0
show,21,9,19,-0.016559013505578396,40,5.321928094887363
turning,6,3,2,-0.030945390487375223,8,3.0
network,3,1,0,-0.02313564298297123,3,1.5849625007211563
worst,23,1,2,-0.161714621256606,25,4.643856189774724
status,1,2,5,0.030416911332941866,6,2.584962500721156
luxury,1,2,0,-0.007751027598355844,1,0.0
scandal,0,1,1,0.007574867880211391,1,0.0
scoring,1,1,0,-0.007751027598355844,1,0.0
jaded,1,1,1,-0.0001174398120963021,2,1.0
fast,3,5,12,0.06846741045214327,15,3.9068905956085187
mopes,1,1,0,-0.007751027598355844,1,0.0
revenge,5,6,4,-0.007985907222548445,9,3.1699250014423126
know,27,7,20,-0.055079271873165025,47,5.554588851677638
costumed,1,1,0,-0.007751027598355844,1,0.0
host,0,1,3,0.022842043452730474,3,1.5849625007211563
attempts,2,4,2,-0.00017615971814445228,4,2.0
focusing,0,1,2,0.015208455666470933,2,1.0
target,9,1,7,-0.015854374633000594,16,4.0
replaced,2,1,1,-0.007809747504403995,3,1.5849625007211563
success,6,2,5,-0.008044627128596597,11,3.4594316186372978
cutthroat,0,1,1,0.007574867880211391,1,0.0
outrageous,2,2,5,0.022724603640634174,7,2.807354922057604
sweetheart,1,2,0,-0.007751027598355844,1,0.0
rhino,1,2,0,-0.007751027598355844,1,0.0
clean,2,2,2,-0.00017615971814445228,4,2.0
exact,2,2,0,-0.015443335290663537,2,1.0
madness,1,3,1,-0.0001174398120963021,2,1.0
bloody,1,1,8,0.053317674691720496,9,3.1699250014423126
lust,0,2,2,0.015208455666470933,2,1.0
hot,7,2,2,-0.03863769817968292,9,3.1699250014423126
scott,1,2,6,0.03805049911920141,7,2.807354922057604
erupt,1,1,0,-0.007751027598355844,1,0.0
1950,1,1,2,0.0075161479741632405,3,1.5849625007211563
mayhem,6,1,1,-0.03857897827363477,7,2.807354922057604
dying,0,2,1,0.007574867880211391,1,0.0
drug,2,10,3,0.0074574280681150885,5,2.321928094887362
efforts,4,1,5,0.007339988256018788,9,3.1699250014423126
necessary,1,2,5,0.030416911332941866,6,2.584962500721156
threat,1,3,1,-0.0001174398120963021,2,1.0
vicious,2,1,0,-0.015443335290663537,2,1.0
brooklyn,3,2,0,-0.02313564298297123,3,1.5849625007211563
directs,2,1,1,-0.007809747504403995,3,1.5849625007211563
streets,2,2,1,-0.007809747504403995,3,1.5849625007211563
means,5,3,7,0.014914856136230177,12,3.5849625007211565
gang,6,5,2,-0.030945390487375223,8,3.0
kalvert,1,1,0,-0.007751027598355844,1,0.0
dysfunctional,4,1,1,-0.023194362889019382,5,2.321928094887362
deuces,7,3,0,-0.053904873752202,7,2.807354922057604
keep,17,6,33,0.12108044627128595,50,5.643856189774724
whatever,8,1,4,-0.031062830299471524,12,3.5849625007211565
drugs,0,6,1,0.007574867880211391,1,0.0
determined,4,3,3,-0.007927187316500297,7,2.807354922057604
members,1,4,3,0.015149735760422781,4,2.0
brothers,3,6,6,0.022665883734586022,9,3.1699250014423126
bad,105,7,17,-0.5087492660011744,122,6.930737337562887
bobby,1,5,0,-0.007751027598355844,1,0.0
hong,2,1,1,-0.007809747504403995,3,1.5849625007211563
experiences,3,4,3,-0.0002348796241926042,6,2.584962500721156
hand,7,1,10,0.02243100411039342,17,4.08746284125034
started,5,1,3,-0.01561949500880799,8,3.0
via,1,2,1,-0.0001174398120963021,2,1.0
travels,0,4,1,0.007574867880211391,1,0.0
zone,2,3,1,-0.007809747504403995,3,1.5849625007211563
ladies,2,1,0,-0.015443335290663537,2,1.0
amazing,0,2,8,0.06100998238402819,8,3.0
confrontation,1,2,0,-0.007751027598355844,1,0.0
such,28,5,40,0.08990017615971815,68,6.08746284125034
prevent,1,5,1,-0.0001174398120963021,2,1.0
main,2,1,3,0.0074574280681150885,5,2.321928094887362
power,9,3,13,0.029947152084556658,22,4.459431618637297
bond,13,3,17,0.029712272460364064,30,4.906890595608519
spectacular,4,1,5,0.007339988256018788,9,3.1699250014423126
speed,1,1,2,0.0075161479741632405,3,1.5849625007211563
consequence,1,1,0,-0.007751027598355844,1,0.0
weapon,1,3,0,-0.007751027598355844,1,0.0
catastrophic,0,1,1,0.007574867880211391,1,0.0
kong,2,1,1,-0.007809747504403995,3,1.5849625007211563
roles,0,2,10,0.07627715795654727,10,3.3219280948873626
cuba,0,2,1,0.007574867880211391,1,0.0
competitors,0,1,1,0.007574867880211391,1,0.0
gangster,6,1,2,-0.030945390487375223,8,3.0
australian,0,2,2,0.015208455666470933,2,1.0
coast,0,2,1,0.007574867880211391,1,0.0
buoyed,0,1,1,0.007574867880211391,1,0.0
soldiers,3,5,4,0.00739870816206694,7,2.807354922057604
infuriates,0,1,1,0.007574867880211391,1,0.0
furious,1,2,0,-0.007751027598355844,1,0.0
sisterhood,2,2,4,0.015091015854374633,6,2.584962500721156
distant,2,2,3,0.0074574280681150885,5,2.321928094887362
flashbacks,1,2,0,-0.007751027598355844,1,0.0
why,26,5,16,-0.0779213153258955,42,5.392317422778761
patch,2,1,0,-0.015443335290663537,2,1.0
verge,0,1,1,0.007574867880211391,1,0.0
copious,0,1,1,0.007574867880211391,1,0.0
walker,1,1,0,-0.007751027598355844,1,0.0
ya,6,4,20,0.10645918966529652,26,4.700439718141093
southern,2,2,3,0.0074574280681150885,5,2.321928094887362
cuts,1,1,5,0.030416911332941866,6,2.584962500721156
opening,6,1,4,-0.015678214914856138,10,3.3219280948873626
unhappy,2,2,0,-0.015443335290663537,2,1.0
fight,7,6,5,-0.01573693482090429,12,3.5849625007211565
wounded,0,1,1,0.007574867880211391,1,0.0
special,18,3,20,0.014151497357604209,38,5.247927513443585
training,0,3,1,0.007574867880211391,1,0.0
active,0,1,1,0.007574867880211391,1,0.0
moon,0,3,2,0.015208455666470933,2,1.0
squad,1,2,0,-0.007751027598355844,1,0.0
encounter,0,4,1,0.007574867880211391,1,0.0
tonight,2,1,1,-0.007809747504403995,3,1.5849625007211563
captain,2,4,0,-0.015443335290663537,2,1.0
forces,3,4,3,-0.0002348796241926042,6,2.584962500721156
scottish,1,1,0,-0.007751027598355844,1,0.0
initially,1,2,0,-0.007751027598355844,1,0.0
water,8,3,6,-0.015795654726952442,14,3.8073549220576037
fish,6,1,0,-0.04621256605989431,6,2.584962500721156
marching,1,1,4,0.022783323546682326,5,2.321928094887362
flounders,2,1,0,-0.015443335290663537,2,1.0
talent,10,1,8,-0.01591309453904874,18,4.169925001442312
realizing,3,1,0,-0.02313564298297123,3,1.5849625007211563
band,3,4,13,0.07610099823840281,16,4.0
drumline,2,1,10,0.060892542571931885,12,3.5849625007211565
expecting,2,1,1,-0.007809747504403995,3,1.5849625007211563
ashley,1,2,0,-0.007751027598355844,1,0.0
legged,5,1,5,-0.00035231943628890455,10,3.3219280948873626
mike,4,3,12,0.06077510275983558,16,4.0
size,1,1,1,-0.0001174398120963021,2,1.0
paranoid,1,1,1,-0.0001174398120963021,2,1.0
spiders,1,1,0,-0.007751027598355844,1,0.0
beasts,0,3,1,0.007574867880211391,1,0.0
group,3,8,5,0.015032295948326481,8,3.0
spill,1,1,0,-0.007751027598355844,1,0.0
unfortunate,3,1,0,-0.02313564298297123,3,1.5849625007211563
hundreds,1,1,0,-0.007751027598355844,1,0.0
eight,6,1,5,-0.008044627128596597,11,3.4594316186372978
st,1,1,0,-0.007751027598355844,1,0.0
leguizamo,3,2,2,-0.007868467410452145,5,2.321928094887362
proposal,1,1,1,-0.0001174398120963021,2,1.0
last,27,6,16,-0.08561362301820319,43,5.426264754702098
enter,2,3,0,-0.015443335290663537,2,1.0
investment,0,1,1,0.007574867880211391,1,0.0
written,12,1,15,0.02213740458015266,27,4.754887502163469
rosa,0,1,1,0.007574867880211391,1,0.0
victor,1,4,2,0.0075161479741632405,3,1.5849625007211563
wall,2,2,5,0.022724603640634174,7,2.807354922057604
bronx,1,2,0,-0.007751027598355844,1,0.0
escape,5,9,4,-0.007985907222548445,9,3.1699250014423126
option,1,1,0,-0.007751027598355844,1,0.0
stockbroker,1,1,0,-0.007751027598355844,1,0.0
dream,1,4,3,0.015149735760422781,4,2.0
wasn,11,1,4,-0.0541397533763946,15,3.9068905956085187
relentlessly,6,1,1,-0.03857897827363477,7,2.807354922057604
try,10,6,5,-0.03881385789782737,15,3.9068905956085187
decides,2,4,0,-0.015443335290663537,2,1.0
previous,6,2,8,0.014856136230182032,14,3.8073549220576037
lopez,5,2,2,-0.02325308279506753,7,2.807354922057604
abused,1,1,0,-0.007751027598355844,1,0.0
played,7,7,8,0.007163828537874339,15,3.9068905956085187
feeling,17,2,20,0.021843805049911902,37,5.20945336562895
bale,2,1,1,-0.007809747504403995,3,1.5849625007211563
strictly,5,1,3,-0.01561949500880799,8,3.0
laws,0,1,2,0.015208455666470933,2,1.0
books,3,1,5,0.015032295948326481,8,3.0
emotion,2,1,2,-0.00017615971814445228,4,2.0
misses,2,1,1,-0.007809747504403995,3,1.5849625007211563
capable,4,1,2,-0.015560775102759838,6,2.584962500721156
dose,0,1,3,0.022842043452730474,3,1.5849625007211563
crime,10,14,7,-0.023546682325308287,17,4.08746284125034
resist,0,1,5,0.03810921902524956,5,2.321928094887362
art,14,7,19,0.03728714034057545,33,5.044394119358453
futuristic,1,2,2,0.0075161479741632405,3,1.5849625007211563
forbidden,1,3,1,-0.0001174398120963021,2,1.0
person,8,5,4,-0.031062830299471524,12,3.5849625007211565
rules,1,3,1,-0.0001174398120963021,2,1.0
emotions,0,1,9,0.06864357017028773,9,3.1699250014423126
church,0,2,1,0.007574867880211391,1,0.0
fact,19,3,4,-0.11567821491485614,23,4.523561956057013
suffer,1,2,1,-0.0001174398120963021,2,1.0
situation,8,5,3,-0.03869641808573107,11,3.4594316186372978
christmas,5,4,4,-0.007985907222548445,9,3.1699250014423126
desmond,0,3,1,0.007574867880211391,1,0.0
sympathetic,0,1,3,0.022842043452730474,3,1.5849625007211563
evelyn,3,2,5,0.015032295948326481,8,3.0
although,11,4,15,0.029829712272460354,26,4.700439718141093
financial,1,1,0,-0.007751027598355844,1,0.0
extreme,13,3,7,-0.046623605402231365,20,4.321928094887363
includes,2,1,4,0.015091015854374633,6,2.584962500721156
catching,1,1,0,-0.007751027598355844,1,0.0
commercial,6,2,6,-0.00041103934233705647,12,3.5849625007211565
jumping,0,1,1,0.007574867880211391,1,0.0
sports,3,2,7,0.030299471520845563,10,3.3219280948873626
sky,0,1,2,0.015208455666470933,2,1.0
locked,0,1,1,0.007574867880211391,1,0.0
enthusiasts,0,1,1,0.007574867880211391,1,0.0
base,1,2,2,0.0075161479741632405,3,1.5849625007211563
near,8,7,8,-0.0005284791544333534,16,4.0
helicopters,0,1,1,0.007574867880211391,1,0.0
criminal,1,5,0,-0.007751027598355844,1,0.0
border,0,1,2,0.015208455666470933,2,1.0
avalanche,1,1,0,-0.007751027598355844,1,0.0
don,41,2,31,-0.07880211391661776,72,6.169925001442312
prominence,1,1,0,-0.007751027598355844,1,0.0
further,7,4,3,-0.031004110393423375,10,3.3219280948873626
frank,4,2,1,-0.023194362889019382,5,2.321928094887362
socially,0,1,1,0.007574867880211391,1,0.0
friendship,0,3,1,0.007574867880211391,1,0.0
quaid,0,1,1,0.007574867880211391,1,0.0
taboo,0,1,3,0.022842043452730474,3,1.5849625007211563
tidy,1,1,1,-0.0001174398120963021,2,1.0
julianne,0,1,2,0.015208455666470933,2,1.0
spinning,1,1,3,0.015149735760422781,4,2.0
50s,0,2,3,0.022842043452730474,3,1.5849625007211563
control,4,4,3,-0.007927187316500297,7,2.807354922057604
sex,4,4,9,0.03787433940105696,13,3.700439718141092
grief,1,1,8,0.053317674691720496,9,3.1699250014423126
confusion,0,1,2,0.015208455666470933,2,1.0
healthy,0,1,1,0.007574867880211391,1,0.0
social,13,6,4,-0.06952436876100998,17,4.08746284125034
honest,5,2,7,0.014914856136230177,12,3.5849625007211565
surprises,6,1,4,-0.015678214914856138,10,3.3219280948873626
feelings,0,3,2,0.015208455666470933,2,1.0
afloat,1,1,4,0.022783323546682326,5,2.321928094887362
despite,27,2,24,-0.024544920728126834,51,5.672425341971496
chapter,1,1,2,0.0075161479741632405,3,1.5849625007211563
frida,8,3,10,0.014738696418085728,18,4.169925001442312
sexual,1,1,4,0.022783323546682326,5,2.321928094887362
illicit,1,1,0,-0.007751027598355844,1,0.0
molina,0,1,1,0.007574867880211391,1,0.0
enduring,0,1,1,0.007574867880211391,1,0.0
artistic,1,3,10,0.06858485026423958,11,3.4594316186372978
bold,1,1,7,0.04568408690546095,8,3.0
lived,2,1,1,-0.007809747504403995,3,1.5849625007211563
couple,7,1,8,0.007163828537874339,15,3.9068905956085187
storm,1,3,1,-0.0001174398120963021,2,1.0
uncompromising,0,2,2,0.015208455666470933,2,1.0
salma,1,1,3,0.015149735760422781,4,2.0
openly,0,1,1,0.007574867880211391,1,0.0
diego,0,3,2,0.015208455666470933,2,1.0
controversial,0,2,1,0.007574867880211391,1,0.0
kahlo,2,2,6,0.030358191426893714,8,3.0
provocative,4,1,6,0.014973576042278329,10,3.3219280948873626
hayek,0,1,5,0.03810921902524956,5,2.321928094887362
alfred,1,1,1,-0.0001174398120963021,2,1.0
rent,7,1,0,-0.053904873752202,7,2.807354922057604
eviction,1,1,0,-0.007751027598355844,1,0.0
someone,13,3,8,-0.03899001761597182,21,4.392317422778761
friday,11,1,4,-0.0541397533763946,15,3.9068905956085187
hood,1,1,0,-0.007751027598355844,1,0.0
parents,7,10,12,0.0376981796829125,19,4.247927513443585
next,22,3,11,-0.08532002348796243,33,5.044394119358453
threatened,1,2,1,-0.0001174398120963021,2,1.0
craig,1,3,2,0.0075161479741632405,3,1.5849625007211563
cash,2,2,0,-0.015443335290663537,2,1.0
stolen,0,3,1,0.007574867880211391,1,0.0
season,4,1,8,0.030240751614797418,12,3.5849625007211565
moved,0,1,7,0.05337639459776864,7,2.807354922057604
posing,2,1,3,0.0074574280681150885,5,2.321928094887362
pick,5,1,4,-0.007985907222548445,9,3.1699250014423126
mall,1,4,1,-0.0001174398120963021,2,1.0
canadian,1,1,1,-0.0001174398120963021,2,1.0
grown,0,2,6,0.0457428068115091,6,2.584962500721156
depths,1,1,1,-0.0001174398120963021,2,1.0
beers,1,1,0,-0.007751027598355844,1,0.0
beer,0,2,1,0.007574867880211391,1,0.0
forming,0,1,1,0.007574867880211391,1,0.0
garage,1,1,0,-0.007751027598355844,1,0.0
science,8,1,4,-0.031062830299471524,12,3.5849625007211565
exploration,0,1,1,0.007574867880211391,1,0.0
dean,2,1,0,-0.015443335290663537,2,1.0
reason,16,2,8,-0.062066940692894895,24,4.584962500721157
enough,67,6,78,0.057310628302994715,145,7.1799090900149345
julia,3,2,0,-0.02313564298297123,3,1.5849625007211563
frontal,7,1,7,-0.0004697592483852084,14,3.8073549220576037
videotape,1,1,0,-0.007751027598355844,1,0.0
seven,3,2,1,-0.015502055196711688,4,2.0
billed,1,1,1,-0.0001174398120963021,2,1.0
movies,53,3,70,0.09612448620082203,123,6.94251450533924
collide,0,2,3,0.022842043452730474,3,1.5849625007211563
11,4,1,4,-0.00029359953024075264,8,3.0
touted,0,1,1,0.007574867880211391,1,0.0
low,28,1,10,-0.13910745742806813,38,5.247927513443585
blair,5,1,0,-0.038520258367586616,5,2.321928094887362
steven,7,3,11,0.030064591896652962,18,4.169925001442312
sequel,16,3,15,-0.00863182618907811,31,4.954196310386876
budget,12,1,8,-0.031297709923664124,20,4.321928094887363
david,7,2,8,0.007163828537874339,15,3.9068905956085187
stamp,0,1,1,0.007574867880211391,1,0.0
pierce,0,1,2,0.015208455666470933,2,1.0
soderbergh,9,1,14,0.0375807398708162,23,4.523561956057013
digitally,1,2,1,-0.0001174398120963021,2,1.0
keener,0,1,1,0.007574867880211391,1,0.0
director,62,5,83,0.11098062243100404,145,7.1799090900149345
conflicts,1,1,0,-0.007751027598355844,1,0.0
five,9,7,5,-0.031121550205519675,14,3.8073549220576037
setting,4,2,3,-0.007927187316500297,7,2.807354922057604
draft,3,1,0,-0.02313564298297123,3,1.5849625007211563
points,12,2,10,-0.016030534351145043,22,4.459431618637297
italian,4,1,1,-0.023194362889019382,5,2.321928094887362
vessel,1,1,0,-0.007751027598355844,1,0.0
1962,1,2,0,-0.007751027598355844,1,0.0
floating,1,3,0,-0.007751027598355844,1,0.0
bizarre,4,4,7,0.02260716382853787,11,3.4594316186372978
series,28,2,14,-0.10857310628302996,42,5.392317422778761
begin,6,7,1,-0.03857897827363477,7,2.807354922057604
missing,7,2,6,-0.00810334703464475,13,3.700439718141092
ghost,6,2,4,-0.015678214914856138,10,3.3219280948873626
inhabited,0,1,1,0.007574867880211391,1,0.0
adrift,1,2,0,-0.007751027598355844,1,0.0
repairing,1,1,0,-0.007751027598355844,1,0.0
creature,0,2,4,0.03047563123899002,4,2.0
liner,1,1,0,-0.007751027598355844,1,0.0
claim,0,2,2,0.015208455666470933,2,1.0
happen,2,5,5,0.022724603640634174,7,2.807354922057604
once,24,9,24,-0.0014679976512037562,48,5.584962500721157
demonic,1,1,0,-0.007751027598355844,1,0.0
ship,6,8,1,-0.03857897827363477,7,2.807354922057604
overweight,1,1,1,-0.0001174398120963021,2,1.0
reveal,0,2,4,0.03047563123899002,4,2.0
rule,1,4,1,-0.0001174398120963021,2,1.0
tech,1,1,1,-0.0001174398120963021,2,1.0
row,0,1,1,0.007574867880211391,1,0.0
motion,5,2,6,0.007281268349970636,11,3.4594316186372978
late,5,4,4,-0.007985907222548445,9,3.1699250014423126
gold,1,2,3,0.015149735760422781,4,2.0
fights,1,1,4,0.022783323546682326,5,2.321928094887362
too,147,5,42,-0.39483264826776276,189,7.562242424221073
us,36,5,71,0.22683499706400467,107,6.7414669864011465
alcatraz,1,1,0,-0.007751027598355844,1,0.0
worth,14,3,31,0.12889019377568994,45,5.491853096329675
cop,8,6,8,-0.0005284791544333534,16,4.0
lunatic,2,1,0,-0.015443335290663537,2,1.0
ja,1,3,0,-0.007751027598355844,1,0.0
crooks,1,2,0,-0.007751027598355844,1,0.0
inmates,1,3,0,-0.007751027598355844,1,0.0
dollars,2,1,0,-0.015443335290663537,2,1.0
usually,4,1,4,-0.00029359953024075264,8,3.0
because,30,8,33,0.02108044627128594,63,5.977279923499917
seagal,15,2,0,-0.11544333529066354,15,3.9068905956085187
undercover,2,3,7,0.037991779213153255,9,3.1699250014423126
apparently,7,1,0,-0.053904873752202,7,2.807354922057604
leading,2,1,1,-0.007809747504403995,3,1.5849625007211563
believe,15,4,6,-0.06964180857310628,21,4.392317422778761
alive,2,4,4,0.015091015854374633,6,2.584962500721156
contest,3,1,1,-0.015502055196711688,4,2.0
internet,1,2,1,-0.0001174398120963021,2,1.0
broadcast,1,1,0,-0.007751027598355844,1,0.0
teens,6,1,3,-0.023311802701115682,9,3.1699250014423126
myers,4,1,2,-0.015560775102759838,6,2.584962500721156
win,3,6,6,0.022665883734586022,9,3.1699250014423126
seems,35,7,24,-0.08608338226658838,59,5.882643049361842
branagh,0,1,1,0.007574867880211391,1,0.0
dreadful,5,1,2,-0.02325308279506753,7,2.807354922057604
arts,1,1,0,-0.007751027598355844,1,0.0
potter,3,5,10,0.05320023487962419,13,3.700439718141092
secrets,5,5,9,0.030182031708749266,14,3.8073549220576037
tom,8,7,6,-0.015795654726952442,14,3.8073549220576037
culprit,1,1,1,-0.0001174398120963021,2,1.0
survival,1,4,1,-0.0001174398120963021,2,1.0
alan,0,1,1,0.007574867880211391,1,0.0
adventures,1,3,2,0.0075161479741632405,3,1.5849625007211563
keeps,9,2,13,0.029947152084556658,22,4.459431618637297
witchcraft,0,2,1,0.007574867880211391,1,0.0
besides,3,1,0,-0.02313564298297123,3,1.5849625007211563
warned,1,3,0,-0.007751027598355844,1,0.0
watson,1,3,0,-0.007751027598355844,1,0.0
hated,1,1,1,-0.0001174398120963021,2,1.0
lurking,1,1,0,-0.007751027598355844,1,0.0
lord,0,2,2,0.015208455666470933,2,1.0
told,8,1,12,0.03000587199060481,20,4.321928094887363
hogwarts,0,10,2,0.015208455666470933,2,1.0
ron,1,3,0,-0.007751027598355844,1,0.0
radcliffe,0,2,1,0.007574867880211391,1,0.0
families,1,3,5,0.030416911332941866,6,2.584962500721156
defense,1,3,0,-0.007751027598355844,1,0.0
knows,4,1,14,0.07604227833235466,18,4.169925001442312
turned,7,5,1,-0.04627128596594246,8,3.0
danger,0,3,1,0.007574867880211391,1,0.0
speak,1,1,5,0.030416911332941866,6,2.584962500721156
flying,0,1,3,0.022842043452730474,3,1.5849625007211563
tongue,1,1,5,0.030416911332941866,6,2.584962500721156
second,10,8,16,0.04515560775102759,26,4.700439718141093
suspects,2,2,0,-0.015443335290663537,2,1.0
kenneth,0,1,1,0.007574867880211391,1,0.0
diary,0,1,2,0.015208455666470933,2,1.0
strangely,5,1,7,0.014914856136230177,12,3.5849625007211565
warning,3,1,0,-0.02313564298297123,3,1.5849625007211563
daniel,0,2,3,0.022842043452730474,3,1.5849625007211563
stone,0,2,4,0.03047563123899002,4,2.0
disaster,7,4,1,-0.04627128596594246,8,3.0
voices,3,1,0,-0.02313564298297123,3,1.5849625007211563
chamber,3,3,3,-0.0002348796241926042,6,2.584962500721156
monster,7,3,6,-0.00810334703464475,13,3.700439718141092
understand,3,1,0,-0.02313564298297123,3,1.5849625007211563
escapes,1,5,1,-0.0001174398120963021,2,1.0
joined,0,3,1,0.007574867880211391,1,0.0
becoming,6,2,6,-0.00041103934233705647,12,3.5849625007211565
wizardry,1,4,1,-0.0001174398120963021,2,1.0
trio,1,1,0,-0.007751027598355844,1,0.0
ride,6,2,29,0.1751614797416324,35,5.129283016944966
everyone,14,7,17,0.02201996476805637,31,4.954196310386876
giving,6,3,8,0.014856136230182032,14,3.8073549220576037
thrust,1,1,1,-0.0001174398120963021,2,1.0
black,18,5,11,-0.05455079271873166,29,4.857980995127573
value,5,1,5,-0.00035231943628890455,10,3.3219280948873626
brutal,1,2,3,0.015149735760422781,4,2.0
moment,8,3,6,-0.015795654726952442,14,3.8073549220576037
unaware,1,1,0,-0.007751027598355844,1,0.0
honor,0,2,3,0.022842043452730474,3,1.5849625007211563
camp,4,8,5,0.007339988256018788,9,3.1699250014423126
generation,5,1,12,0.05308279506752789,17,4.08746284125034
planning,1,2,0,-0.007751027598355844,1,0.0
defend,0,2,1,0.007574867880211391,1,0.0
accused,0,4,2,0.015208455666470933,2,1.0
uses,2,3,9,0.053258954785672344,11,3.4594316186372978
martial,1,1,2,0.0075161479741632405,3,1.5849625007211563
pow,1,1,1,-0.0001174398120963021,2,1.0
country,3,3,4,0.00739870816206694,7,2.807354922057604
german,0,4,1,0.007574867880211391,1,0.0
bulge,0,1,1,0.007574867880211391,1,0.0
obviously,8,1,1,-0.05396359365825015,9,3.1699250014423126
fourth,1,2,2,0.0075161479741632405,3,1.5849625007211563
racist,3,1,0,-0.02313564298297123,3,1.5849625007211563
highest,1,1,1,-0.0001174398120963021,2,1.0
carry,0,1,7,0.05337639459776864,7,2.807354922057604
stalag,0,1,1,0.007574867880211391,1,0.0
destroy,0,3,1,0.007574867880211391,1,0.0
itself,34,4,26,-0.06312389900176157,60,5.906890595608519
men,13,11,9,-0.031356429829712276,22,4.459431618637297
major,10,3,4,-0.04644744568408691,14,3.8073549220576037
risky,0,1,2,0.015208455666470933,2,1.0
lieutenant,0,4,1,0.007574867880211391,1,0.0
hero,7,3,11,0.030064591896652962,18,4.169925001442312
eye,5,3,16,0.08361714621256605,21,4.392317422778761
front,1,1,3,0.015149735760422781,4,2.0
william,0,1,1,0.007574867880211391,1,0.0
commands,1,1,0,-0.007751027598355844,1,0.0
tommy,0,1,1,0.007574867880211391,1,0.0
captured,1,3,1,-0.0001174398120963021,2,1.0
miserably,1,1,0,-0.007751027598355844,1,0.0
places,2,1,3,0.0074574280681150885,5,2.321928094887362
spielberg,3,1,20,0.1295361127422196,23,4.523561956057013
stanley,0,1,1,0.007574867880211391,1,0.0
ribisi,1,1,1,-0.0001174398120963021,2,1.0
want,15,4,20,0.03722842043452729,35,5.129283016944966
i,189,2,124,-0.09001761597181446,313,8.290018846932618
bomb,2,3,0,-0.015443335290663537,2,1.0
installment,5,1,1,-0.030886670581327075,6,2.584962500721156
office,2,1,4,0.015091015854374633,6,2.584962500721156
existence,1,4,0,-0.007751027598355844,1,0.0
four,10,5,7,-0.023546682325308287,17,4.08746284125034
deserves,7,1,9,0.01479741632413388,16,4.0
twyker,0,1,1,0.007574867880211391,1,0.0
unlikely,2,4,5,0.022724603640634174,7,2.807354922057604
soul,3,2,11,0.06083382266588373,14,3.8073549220576037
ignore,2,1,1,-0.007809747504403995,3,1.5849625007211563
believes,0,3,1,0.007574867880211391,1,0.0
kubrick,0,1,4,0.03047563123899002,4,2.0
supposedly,2,1,2,-0.00017615971814445228,4,2.0
bleak,1,1,4,0.022783323546682326,5,2.321928094887362
kieslowski,3,2,2,-0.007868467410452145,5,2.321928094887362
disappointed,5,1,5,-0.00035231943628890455,10,3.3219280948873626
trilogy,1,1,1,-0.0001174398120963021,2,1.0
unfortunately,11,2,1,-0.07704051673517323,12,3.5849625007211565
lax,1,1,0,-0.007751027598355844,1,0.0
lola,2,1,0,-0.015443335290663537,2,1.0
redemption,3,1,4,0.00739870816206694,7,2.807354922057604
fails,16,2,3,-0.10023487962419261,19,4.247927513443585
among,3,2,9,0.04556664709336465,12,3.5849625007211565
lovers,0,2,7,0.05337639459776864,7,2.807354922057604
cover,4,3,2,-0.015560775102759838,6,2.584962500721156
collapses,4,2,1,-0.023194362889019382,5,2.321928094887362
information,0,4,2,0.015208455666470933,2,1.0
building,3,1,2,-0.007868467410452145,5,2.321928094887362
changes,2,1,2,-0.00017615971814445228,4,2.0
tries,17,6,5,-0.09266001174398122,22,4.459431618637297
heaven,4,1,13,0.06840869054609512,17,4.08746284125034
directed,15,2,16,0.006694069289489124,31,4.954196310386876
changing,1,3,8,0.053317674691720496,9,3.1699250014423126
descends,1,1,0,-0.007751027598355844,1,0.0
blanchett,0,1,2,0.015208455666470933,2,1.0
awry,1,2,0,-0.007751027598355844,1,0.0
knock,2,1,1,-0.007809747504403995,3,1.5849625007211563
disappear,1,1,0,-0.007751027598355844,1,0.0
neighborhood,0,3,3,0.022842043452730474,3,1.5849625007211563
likes,0,1,3,0.022842043452730474,3,1.5849625007211563
build,4,1,5,0.007339988256018788,9,3.1699250014423126
stores,1,1,1,-0.0001174398120963021,2,1.0
gerald,0,1,1,0.007574867880211391,1,0.0
mr,9,5,19,0.07574867880211392,28,4.807354922057604
plex,1,1,0,-0.007751027598355844,1,0.0
superhero,0,1,1,0.007574867880211391,1,0.0
crucial,2,1,2,-0.00017615971814445228,4,2.0
beloved,1,2,4,0.022783323546682326,5,2.321928094887362
stranger,0,2,3,0.022842043452730474,3,1.5849625007211563
looks,20,1,8,-0.09283617146212567,28,4.807354922057604
revealed,1,2,0,-0.007751027598355844,1,0.0
assigned,1,3,1,-0.0001174398120963021,2,1.0
latin,2,1,1,-0.007809747504403995,3,1.5849625007211563
rather,26,3,25,-0.009219025249559615,51,5.672425341971496
wet,3,1,1,-0.015502055196711688,4,2.0
military,2,4,3,0.0074574280681150885,5,2.321928094887362
died,3,2,1,-0.015502055196711688,4,2.0
system,2,2,2,-0.00017615971814445228,4,2.0
unconventional,0,2,1,0.007574867880211391,1,0.0
ears,2,1,0,-0.015443335290663537,2,1.0
powered,1,1,1,-0.0001174398120963021,2,1.0
claire,0,3,1,0.007574867880211391,1,0.0
allen,9,1,11,0.014679976512037576,20,4.321928094887363
woody,9,1,3,-0.046388725778038764,12,3.5849625007211565
producers,4,1,1,-0.023194362889019382,5,2.321928094887362
directing,3,2,2,-0.007868467410452145,5,2.321928094887362
knowing,2,2,2,-0.00017615971814445228,4,2.0
paranoia,0,1,1,0.007574867880211391,1,0.0
commercials,0,1,1,0.007574867880211391,1,0.0
executives,0,1,1,0.007574867880211391,1,0.0
studio,3,3,7,0.030299471520845563,10,3.3219280948873626
blind,3,3,0,-0.02313564298297123,3,1.5849625007211563
reduced,1,1,1,-0.0001174398120963021,2,1.0
clash,0,1,1,0.007574867880211391,1,0.0
eyes,2,2,8,0.0456253669994128,10,3.3219280948873626
slice,1,2,6,0.03805049911920141,7,2.807354922057604
fling,1,1,0,-0.007751027598355844,1,0.0
flirts,0,1,1,0.007574867880211391,1,0.0
relationships,3,4,6,0.022665883734586022,9,3.1699250014423126
favorite,1,1,1,-0.0001174398120963021,2,1.0
pushing,1,1,0,-0.007751027598355844,1,0.0
thirty,2,1,0,-0.015443335290663537,2,1.0
oliver,0,1,2,0.015208455666470933,2,1.0
bittersweet,0,1,2,0.015208455666470933,2,1.0
casual,2,2,3,0.0074574280681150885,5,2.321928094887362
thing,45,4,17,-0.2164415736934821,62,5.954196310386876
peace,0,3,1,0.007574867880211391,1,0.0
namely,0,1,1,0.007574867880211391,1,0.0
rugged,0,1,1,0.007574867880211391,1,0.0
assertive,0,1,1,0.007574867880211391,1,0.0
jersey,3,1,0,-0.02313564298297123,3,1.5849625007211563
hearts,1,1,5,0.030416911332941866,6,2.584962500721156
bar,2,1,0,-0.015443335290663537,2,1.0
indifferent,1,1,0,-0.007751027598355844,1,0.0
rick,0,2,1,0.007574867880211391,1,0.0
wonders,0,1,3,0.022842043452730474,3,1.5849625007211563
essentially,4,1,4,-0.00029359953024075264,8,3.0
driven,2,3,4,0.015091015854374633,6,2.584962500721156
versus,1,1,1,-0.0001174398120963021,2,1.0
album,2,2,2,-0.00017615971814445228,4,2.0
featured,1,1,0,-0.007751027598355844,1,0.0
bit,17,1,23,0.04474456840869054,40,5.321928094887363
jones,0,2,12,0.09154433352906635,12,3.5849625007211565
wilco,2,2,7,0.037991779213153255,9,3.1699250014423126
desire,1,1,3,0.015149735760422781,4,2.0
yankee,1,2,0,-0.007751027598355844,1,0.0
strays,1,1,1,-0.0001174398120963021,2,1.0
alt,1,1,0,-0.007751027598355844,1,0.0
song,4,1,2,-0.015560775102759838,6,2.584962500721156
conflict,4,1,8,0.030240751614797418,12,3.5849625007211565
boxing,3,3,1,-0.015502055196711688,4,2.0
treacherous,1,1,0,-0.007751027598355844,1,0.0
wilson,7,1,1,-0.04627128596594246,8,3.0
spies,1,2,0,-0.007751027598355844,1,0.0
champion,1,1,2,0.0075161479741632405,3,1.5849625007211563
humor,30,1,42,0.08978273634762182,72,6.169925001442312
sophisticated,1,2,6,0.03805049911920141,7,2.807354922057604
yet,17,6,29,0.09054609512624778,46,5.523561956057013
called,11,10,0,-0.08467410452143277,11,3.4594316186372978
parts,3,1,4,0.00739870816206694,7,2.807354922057604
switchblade,1,1,0,-0.007751027598355844,1,0.0
cocky,2,1,2,-0.00017615971814445228,4,2.0
created,6,1,7,0.007222548443922484,13,3.700439718141092
foil,0,1,1,0.007574867880211391,1,0.0
skill,3,1,4,0.00739870816206694,7,2.807354922057604
murphy,12,2,5,-0.054198473282442754,17,4.08746284125034
catch,6,5,9,0.022489724016441573,15,3.9068905956085187
robinson,1,1,1,-0.0001174398120963021,2,1.0
owen,2,1,0,-0.015443335290663537,2,1.0
equal,1,1,6,0.03805049911920141,7,2.807354922057604
expect,7,2,10,0.02243100411039342,17,4.08746284125034
plane,0,1,1,0.007574867880211391,1,0.0
animals,2,5,0,-0.015443335290663537,2,1.0
woolly,0,1,2,0.015208455666470933,2,1.0
talking,3,1,4,0.00739870816206694,7,2.807354922057604
age,10,3,18,0.06042278332354667,28,4.807354922057604
baby,1,4,4,0.022783323546682326,5,2.321928094887362
planet,2,6,7,0.037991779213153255,9,3.1699250014423126
kinds,0,1,2,0.015208455666470933,2,1.0
deadly,3,2,2,-0.007868467410452145,5,2.321928094887362
elements,7,1,7,-0.0004697592483852084,14,3.8073549220576037
else,17,2,4,-0.10029359953024075,21,4.392317422778761
sleeping,2,1,0,-0.015443335290663537,2,1.0
jumps,0,1,2,0.015208455666470933,2,1.0
our,11,3,42,0.23593658250146798,53,5.7279204545632
overrun,1,1,2,0.0075161479741632405,3,1.5849625007211563
drowns,2,1,0,-0.015443335290663537,2,1.0
loving,2,2,3,0.0074574280681150885,5,2.321928094887362
ice,9,4,10,0.0070463887257780355,19,4.247927513443585
sid,0,3,1,0.007574867880211391,1,0.0
stupid,16,1,2,-0.10786846741045215,18,4.169925001442312
20,3,3,2,-0.007868467410452145,5,2.321928094887362
earth,4,6,5,0.007339988256018788,9,3.1699250014423126
impending,0,1,1,0.007574867880211391,1,0.0
happily,0,1,4,0.03047563123899002,4,2.0
veers,3,1,1,-0.015502055196711688,4,2.0
removed,1,1,0,-0.007751027598355844,1,0.0
insanity,1,1,1,-0.0001174398120963021,2,1.0
expectation,1,1,1,-0.0001174398120963021,2,1.0
standards,5,1,4,-0.007985907222548445,9,3.1699250014423126
deviant,1,1,0,-0.007751027598355844,1,0.0
truly,10,2,9,-0.008279506752789198,19,4.247927513443585
artists,0,2,2,0.015208455666470933,2,1.0
several,10,1,11,0.006987668819729884,21,4.392317422778761
holds,4,2,4,-0.00029359953024075264,8,3.0
caulfield,1,1,0,-0.007751027598355844,1,0.0
trip,7,3,5,-0.01573693482090429,12,3.5849625007211565
intellectual,3,1,5,0.015032295948326481,8,3.0
underworld,0,1,1,0.007574867880211391,1,0.0
older,5,2,4,-0.007985907222548445,9,3.1699250014423126
darkly,1,1,3,0.015149735760422781,4,2.0
comic,13,2,23,0.07551379917792131,36,5.169925001442312
oppressive,1,2,1,-0.0001174398120963021,2,1.0
performance,19,1,53,0.24310041103934232,72,6.169925001442312
bohemian,1,1,0,-0.007751027598355844,1,0.0
igby,0,6,5,0.03810921902524956,5,2.321928094887362
bored,5,1,3,-0.01561949500880799,8,3.0
prep,1,1,0,-0.007751027598355844,1,0.0
terminally,2,1,1,-0.007809747504403995,3,1.5849625007211563
dealing,3,1,1,-0.015502055196711688,4,2.0
schools,1,1,0,-0.007751027598355844,1,0.0
better,48,2,41,-0.056312389900176174,89,6.475733430966398
absorbed,0,2,1,0.007574867880211391,1,0.0
far,34,2,32,-0.017322372284204357,66,6.044394119358453
noble,2,1,4,0.015091015854374633,6,2.584962500721156
modern,8,4,16,0.06054022313564297,24,4.584962500721157
figures,0,2,3,0.022842043452730474,3,1.5849625007211563
holden,1,2,1,-0.0001174398120963021,2,1.0
sarcastic,0,1,1,0.007574867880211391,1,0.0
feature,13,2,16,0.02207868467410451,29,4.857980995127573
enemies,1,2,0,-0.007751027598355844,1,0.0
creates,2,2,4,0.015091015854374633,6,2.584962500721156
suspected,1,2,0,-0.007751027598355844,1,0.0
impostor,10,1,0,-0.07698179682912508,10,3.3219280948873626
philip,3,2,3,-0.0002348796241926042,6,2.584962500721156
character,42,3,46,0.0280093951849677,88,6.459431618637298
minute,16,1,15,-0.00863182618907811,31,4.954196310386876
alien,0,5,3,0.022842043452730474,3,1.5849625007211563
originally,0,1,1,0.007574867880211391,1,0.0
aliens,1,3,6,0.03805049911920141,7,2.807354922057604
use,4,6,7,0.02260716382853787,11,3.4594316186372978
dick,4,2,2,-0.015560775102759838,6,2.584962500721156
portion,1,1,0,-0.007751027598355844,1,0.0
framing,1,1,0,-0.007751027598355844,1,0.0
pacino,0,1,11,0.08391074574280681,11,3.4594316186372978
small,9,8,11,0.014679976512037576,20,4.321928094887363
got,10,3,14,0.029888432178508506,24,4.584962500721157
admitting,0,1,1,0.007574867880211391,1,0.0
addition,3,1,4,0.00739870816206694,7,2.807354922057604
swank,1,1,1,-0.0001174398120963021,2,1.0
teenage,2,1,4,0.015091015854374633,6,2.584962500721156
crashing,1,1,1,-0.0001174398120963021,2,1.0
complexity,0,1,2,0.015208455666470933,2,1.0
johnny,1,2,0,-0.007751027598355844,1,0.0
entertaining,13,2,58,0.3274221961244862,71,6.149747119504682
jackass,3,2,3,-0.0002348796241926042,6,2.584962500721156
stunts,9,1,6,-0.023487962419260135,15,3.9068905956085187
civilized,1,1,0,-0.007751027598355844,1,0.0
knoxville,1,1,0,-0.007751027598355844,1,0.0
wander,1,1,2,0.0075161479741632405,3,1.5849625007211563
emergency,0,2,2,0.015208455666470933,2,1.0
archibald,1,1,0,-0.007751027598355844,1,0.0
immediately,2,3,1,-0.007809747504403995,3,1.5849625007211563
would,72,4,33,-0.2635349383440987,105,6.714245517666122
playing,10,3,3,-0.05408103347034646,13,3.700439718141092
q,6,1,1,-0.03857897827363477,7,2.807354922057604
recovery,0,1,2,0.015208455666470933,2,1.0
message,14,1,9,-0.03904873752201997,23,4.523561956057013
whale,2,1,2,-0.00017615971814445228,4,2.0
jonah,5,5,2,-0.02325308279506753,7,2.807354922057604
joint,1,2,0,-0.007751027598355844,1,0.0
settle,4,2,1,-0.023194362889019382,5,2.321928094887362
deliver,5,1,4,-0.007985907222548445,9,3.1699250014423126
veggies,0,1,3,0.022842043452730474,3,1.5849625007211563
anything,26,3,12,-0.10845566647093366,38,5.247927513443585
came,3,1,2,-0.007868467410452145,5,2.321928094887362
wait,6,1,5,-0.008044627128596597,11,3.4594316186372978
truck,2,2,0,-0.015443335290663537,2,1.0
quite,34,2,32,-0.017322372284204357,66,6.044394119358453
adventure,9,4,17,0.060481503229594835,26,4.700439718141093
messages,4,1,1,-0.023194362889019382,5,2.321928094887362
showdown,1,1,1,-0.0001174398120963021,2,1.0
kind,35,3,31,-0.032648267762771604,66,6.044394119358453
direction,13,1,16,0.02207868467410451,29,4.857980995127573
singing,2,2,1,-0.007809747504403995,3,1.5849625007211563
trouble,4,3,7,0.02260716382853787,11,3.4594316186372978
stranded,0,1,1,0.007574867880211391,1,0.0
god,4,1,4,-0.00029359953024075264,8,3.0
belly,2,1,4,0.015091015854374633,6,2.584962500721156
van,1,2,1,-0.0001174398120963021,2,1.0
pirate,1,2,0,-0.007751027598355844,1,0.0
untrained,0,1,2,0.015208455666470933,2,1.0
fox,0,1,1,0.007574867880211391,1,0.0
dress,2,2,0,-0.015443335290663537,2,1.0
undisciplined,0,1,1,0.007574867880211391,1,0.0
mann,3,2,0,-0.02313564298297123,3,1.5849625007211563
any,62,4,55,-0.04932472108044628,117,6.870364719583405
surprise,7,2,9,0.01479741632413388,16,4.0
juwanna,4,3,0,-0.030827950675278923,4,2.0
league,2,2,1,-0.007809747504403995,3,1.5849625007211563
jr,1,5,1,-0.0001174398120963021,2,1.0
shows,6,4,15,0.06829125073399882,21,4.392317422778761
antics,1,1,3,0.015149735760422781,4,2.0
ballistic,10,1,0,-0.07698179682912508,10,3.3219280948873626
atlantic,0,1,3,0.022842043452730474,3,1.5849625007211563
super,4,2,3,-0.007927187316500297,7,2.807354922057604
races,3,1,1,-0.015502055196711688,4,2.0
potential,6,3,10,0.030123311802701114,16,4.0
ignite,1,1,0,-0.007751027598355844,1,0.0
suffered,1,1,0,-0.007751027598355844,1,0.0
dangerously,1,1,2,0.0075161479741632405,3,1.5849625007211563
ops,6,1,2,-0.030945390487375223,8,3.0
ordinary,4,1,2,-0.015560775102759838,6,2.584962500721156
forms,0,2,1,0.007574867880211391,1,0.0
obsessive,0,3,2,0.015208455666470933,2,1.0
comfortable,1,2,4,0.022783323546682326,5,2.321928094887362
nice,2,2,12,0.07615971814445097,14,3.8073549220576037
theater,20,2,11,-0.06993540810334704,31,4.954196310386876
iconoclastic,0,1,1,0.007574867880211391,1,0.0
chronicle,1,2,0,-0.007751027598355844,1,0.0
weaves,0,1,2,0.015208455666470933,2,1.0
scenes,28,4,24,-0.03223722842043453,52,5.700439718141093
haunting,1,1,9,0.06095126247798004,10,3.3219280948873626
tenacity,0,2,1,0.007574867880211391,1,0.0
piece,11,5,24,0.09853200234879625,35,5.129283016944966
performances,18,2,49,0.23552554315913096,67,6.066089190457772
disturbing,2,2,6,0.030358191426893714,8,3.0
revelation,1,2,4,0.022783323546682326,5,2.321928094887362
wide,3,1,3,-0.0002348796241926042,6,2.584962500721156
wit,12,2,8,-0.031297709923664124,20,4.321928094887363
months,1,3,1,-0.0001174398120963021,2,1.0
dance,1,1,8,0.053317674691720496,9,3.1699250014423126
collaboration,1,1,2,0.0075161479741632405,3,1.5849625007211563
sendak,1,2,0,-0.007751027598355844,1,0.0
stormy,1,2,0,-0.007751027598355844,1,0.0
directors,6,1,5,-0.008044627128596597,11,3.4594316186372978
footage,5,2,4,-0.007985907222548445,9,3.1699250014423126
interviews,0,3,1,0.007574867880211391,1,0.0
dynamic,1,1,2,0.0075161479741632405,3,1.5849625007211563
born,0,2,4,0.03047563123899002,4,2.0
cross,3,2,5,0.015032295948326481,8,3.0
liberal,2,1,1,-0.007809747504403995,3,1.5849625007211563
aware,1,1,7,0.04568408690546095,8,3.0
speaking,0,1,3,0.022842043452730474,3,1.5849625007211563
pause,1,1,0,-0.007751027598355844,1,0.0
english,2,2,2,-0.00017615971814445228,4,2.0
lifestyle,1,1,1,-0.0001174398120963021,2,1.0
audiences,6,1,8,0.014856136230182032,14,3.8073549220576037
providing,1,1,4,0.022783323546682326,5,2.321928094887362
beginning,4,2,5,0.007339988256018788,9,3.1699250014423126
expression,1,1,0,-0.007751027598355844,1,0.0
indian,0,2,2,0.015208455666470933,2,1.0
universal,3,1,2,-0.007868467410452145,5,2.321928094887362
community,5,2,5,-0.00035231943628890455,10,3.3219280948873626
uncomfortable,0,1,1,0.007574867880211391,1,0.0
reflection,1,1,3,0.015149735760422781,4,2.0
exquisite,2,1,0,-0.015443335290663537,2,1.0
moving,7,2,14,0.052965355255431584,21,4.392317422778761
blend,0,2,11,0.08391074574280681,11,3.4594316186372978
emerge,1,1,1,-0.0001174398120963021,2,1.0
mainstream,4,2,8,0.030240751614797418,12,3.5849625007211565
sparks,2,1,2,-0.00017615971814445228,4,2.0
kerrigan,1,1,0,-0.007751027598355844,1,0.0
lanie,1,1,0,-0.007751027598355844,1,0.0
score,2,1,12,0.07615971814445097,14,3.8073549220576037
fluff,5,1,1,-0.030886670581327075,6,2.584962500721156
football,1,1,1,-0.0001174398120963021,2,1.0
jolie,3,1,4,0.00739870816206694,7,2.807354922057604
connected,0,2,1,0.007574867880211391,1,0.0
shoes,0,3,1,0.007574867880211391,1,0.0
lightning,0,1,2,0.015208455666470933,2,1.0
faded,1,1,0,-0.007751027598355844,1,0.0
letters,1,3,0,-0.007751027598355844,1,0.0
nba,2,1,2,-0.00017615971814445228,4,2.0
unbelievable,2,1,2,-0.00017615971814445228,4,2.0
die,8,2,6,-0.015795654726952442,14,3.8073549220576037
finished,1,1,0,-0.007751027598355844,1,0.0
link,0,1,1,0.007574867880211391,1,0.0
ouija,1,1,0,-0.007751027598355844,1,0.0
spirits,0,1,5,0.03810921902524956,5,2.321928094887362
reigen,1,1,0,-0.007751027598355844,1,0.0
schnitzler,1,1,0,-0.007751027598355844,1,0.0
awkward,2,1,3,0.0074574280681150885,5,2.321928094887362
backdrop,1,1,2,0.0075161479741632405,3,1.5849625007211563
sleazy,2,1,0,-0.015443335290663537,2,1.0
serves,3,1,4,0.00739870816206694,7,2.807354922057604
phone,2,1,1,-0.007809747504403995,3,1.5849625007211563
moves,1,4,4,0.022783323546682326,5,2.321928094887362
loosely,1,1,0,-0.007751027598355844,1,0.0
fiennes,3,2,1,-0.015502055196711688,4,2.0
guest,1,1,0,-0.007751027598355844,1,0.0
pair,1,2,3,0.015149735760422781,4,2.0
fate,1,2,1,-0.0001174398120963021,2,1.0
steps,0,1,3,0.022842043452730474,3,1.5849625007211563
apart,8,3,5,-0.023429242513211983,13,3.700439718141092
marshall,0,1,5,0.03810921902524956,5,2.321928094887362
worlds,1,2,1,-0.0001174398120963021,2,1.0
throws,3,1,2,-0.007868467410452145,5,2.321928094887362
twist,7,2,5,-0.01573693482090429,12,3.5849625007211565
christopher,0,2,3,0.022842043452730474,3,1.5849625007211563
maid,4,1,3,-0.007927187316500297,7,2.807354922057604
view,6,2,4,-0.015678214914856138,10,3.3219280948873626
commentary,5,1,2,-0.02325308279506753,7,2.807354922057604
metaphorical,1,1,2,0.0075161479741632405,3,1.5849625007211563
public,3,1,3,-0.0002348796241926042,6,2.584962500721156
delivers,5,1,25,0.15231943628890193,30,4.906890595608519
piercing,0,1,1,0.007574867880211391,1,0.0
lifting,1,1,0,-0.007751027598355844,1,0.0
raucous,2,1,0,-0.015443335290663537,2,1.0
dangers,1,2,0,-0.007751027598355844,1,0.0
race,1,3,2,0.0075161479741632405,3,1.5849625007211563
proportions,1,1,1,-0.0001174398120963021,2,1.0
clock,1,1,1,-0.0001174398120963021,2,1.0
sexy,2,1,7,0.037991779213153255,9,3.1699250014423126
model,0,1,1,0.007574867880211391,1,0.0
spent,5,1,2,-0.02325308279506753,7,2.807354922057604
jay,5,3,1,-0.030886670581327075,6,2.584962500721156
kay,0,2,1,0.007574867880211391,1,0.0
convince,1,1,1,-0.0001174398120963021,2,1.0
diabolical,1,1,1,-0.0001174398120963021,2,1.0
completely,15,2,7,-0.06200822078684675,22,4.459431618637297
mib,3,1,1,-0.015502055196711688,4,2.0
names,2,1,1,-0.007809747504403995,3,1.5849625007211563
killers,0,1,1,0.007574867880211391,1,0.0
predict,0,1,2,0.015208455666470933,2,1.0
commits,0,1,1,0.007574867880211391,1,0.0
courtesy,1,1,1,-0.0001174398120963021,2,1.0
tank,1,1,2,0.0075161479741632405,3,1.5849625007211563
dilemma,1,2,0,-0.007751027598355844,1,0.0
division,0,4,1,0.007574867880211391,1,0.0
imagery,3,1,6,0.022665883734586022,9,3.1699250014423126
nobody,3,1,1,-0.015502055196711688,4,2.0
six,5,2,1,-0.030886670581327075,6,2.584962500721156
report,10,2,9,-0.008279506752789198,19,4.247927513443585
accept,0,4,1,0.007574867880211391,1,0.0
less,36,2,26,-0.07850851438637696,62,5.954196310386876
trace,2,1,0,-0.015443335290663537,2,1.0
drop,3,1,3,-0.0002348796241926042,6,2.584962500721156
rapidly,0,1,1,0.007574867880211391,1,0.0
key,2,1,2,-0.00017615971814445228,4,2.0
crimes,10,1,5,-0.03881385789782737,15,3.9068905956085187
hold,6,3,8,0.014856136230182032,14,3.8073549220576037
department,1,3,1,-0.0001174398120963021,2,1.0
technology,2,3,5,0.022724603640634174,7,2.807354922057604
cops,1,2,3,0.015149735760422781,4,2.0
rate,3,1,4,0.00739870816206694,7,2.807354922057604
pre,2,2,1,-0.007809747504403995,3,1.5849625007211563
victim,3,2,1,-0.015502055196711688,4,2.0
diminishing,1,1,0,-0.007751027598355844,1,0.0
minority,3,2,5,0.015032295948326481,8,3.0
viewing,3,2,5,0.015032295948326481,8,3.0
cruise,0,2,3,0.022842043452730474,3,1.5849625007211563
presented,2,1,1,-0.007809747504403995,3,1.5849625007211563
lingers,0,1,1,0.007574867880211391,1,0.0
intentions,2,2,2,-0.00017615971814445228,4,2.0
early,6,2,4,-0.015678214914856138,10,3.3219280948873626
drawn,3,2,3,-0.0002348796241926042,6,2.584962500721156
opportunists,0,1,1,0.007574867880211391,1,0.0
necessarily,3,1,1,-0.015502055196711688,4,2.0
rolling,2,2,4,0.015091015854374633,6,2.584962500721156
uncle,0,4,2,0.015208455666470933,2,1.0
dough,0,1,1,0.007574867880211391,1,0.0
exposé,1,1,0,-0.007751027598355844,1,0.0
deeds,1,5,6,0.03805049911920141,7,2.807354922057604
pie,3,1,1,-0.015502055196711688,4,2.0
40,6,2,2,-0.030945390487375223,8,3.0
naiveté,0,1,1,0.007574867880211391,1,0.0
sincere,4,1,6,0.014973576042278329,10,3.3219280948873626
gunning,0,1,1,0.007574867880211391,1,0.0
smith,0,3,2,0.015208455666470933,2,1.0
employs,1,1,2,0.0075161479741632405,3,1.5849625007211563
mistake,6,1,3,-0.023311802701115682,9,3.1699250014423126
pay,9,3,3,-0.046388725778038764,12,3.5849625007211565
male,6,3,3,-0.023311802701115682,9,3.1699250014423126
neither,24,1,3,-0.16177334116265416,27,4.754887502163469
consequences,2,1,0,-0.015443335290663537,2,1.0
unintended,1,1,0,-0.007751027598355844,1,0.0
meeting,0,1,1,0.007574867880211391,1,0.0
afford,0,1,1,0.007574867880211391,1,0.0
sandra,5,1,5,-0.00035231943628890455,10,3.3219280948873626
ryan,4,1,2,-0.015560775102759838,6,2.584962500721156
thriller,47,1,48,0.004815032295948318,95,6.569855608330948
bullock,9,3,12,0.022313564298297117,21,4.392317422778761
ingenious,0,1,4,0.03047563123899002,4,2.0
brilliant,4,3,16,0.09130945390487374,20,4.321928094887363
suspense,17,1,13,-0.031591309453904884,30,4.906890595608519
numbers,19,1,4,-0.11567821491485614,23,4.523561956057013
gosling,0,1,1,0.007574867880211391,1,0.0
psychological,10,1,10,-0.0006459189665296572,20,4.321928094887363
dancing,2,1,4,0.015091015854374633,6,2.584962500721156
greek,3,4,8,0.03793305930710511,11,3.4594316186372978
think,27,4,18,-0.07034644744568411,45,5.491853096329675
computer,8,6,3,-0.03869641808573107,11,3.4594316186372978
fool,3,1,2,-0.007868467410452145,5,2.321928094887362
miller,1,1,1,-0.0001174398120963021,2,1.0
belt,2,1,2,-0.00017615971814445228,4,2.0
wasp,0,1,1,0.007574867880211391,1,0.0
again,22,1,18,-0.03188490898414564,40,5.321928094887363
ian,1,3,1,-0.0001174398120963021,2,1.0
date,6,2,6,-0.00041103934233705647,12,3.5849625007211565
prize,1,1,2,0.0075161479741632405,3,1.5849625007211563
apply,2,1,3,0.0074574280681150885,5,2.321928094887362
move,5,2,3,-0.01561949500880799,8,3.0
wanting,1,2,1,-0.0001174398120963021,2,1.0
overcome,3,1,4,0.00739870816206694,7,2.807354922057604
cameras,1,2,0,-0.007751027598355844,1,0.0
test,6,3,1,-0.03857897827363477,7,2.807354922057604
1,1,3,1,-0.0001174398120963021,2,1.0
whilst,0,1,1,0.007574867880211391,1,0.0
morality,3,1,4,0.00739870816206694,7,2.807354922057604
filmed,5,1,2,-0.02325308279506753,7,2.807354922057604
dies,1,3,0,-0.007751027598355844,1,0.0
danny,2,1,0,-0.015443335290663537,2,1.0
watched,3,1,2,-0.007868467410452145,5,2.321928094887362
blood,3,3,10,0.05320023487962419,13,3.700439718141092
tidal,2,1,0,-0.015443335290663537,2,1.0
reflects,1,1,1,-0.0001174398120963021,2,1.0
dominated,1,1,1,-0.0001174398120963021,2,1.0
shift,1,1,0,-0.007751027598355844,1,0.0
concert,3,1,4,0.00739870816206694,7,2.807354922057604
intimacy,1,1,1,-0.0001174398120963021,2,1.0
nature,2,1,5,0.022724603640634174,7,2.807354922057604
digital,6,1,6,-0.00041103934233705647,12,3.5849625007211565
visually,9,1,7,-0.015854374633000594,16,4.0
extremes,1,1,1,-0.0001174398120963021,2,1.0
cinematic,21,1,21,-0.0012918379330593144,42,5.392317422778761
images,2,1,7,0.037991779213153255,9,3.1699250014423126
rise,0,1,3,0.022842043452730474,3,1.5849625007211563
mesmerizing,0,1,4,0.03047563123899002,4,2.0
spectacle,2,1,9,0.053258954785672344,11,3.4594316186372978
unique,0,1,10,0.07627715795654727,10,3.3219280948873626
everyday,0,1,6,0.0457428068115091,6,2.584962500721156
synthetic,1,2,1,-0.0001174398120963021,2,1.0
wave,4,1,3,-0.007927187316500297,7,2.807354922057604
visuals,1,1,5,0.030416911332941866,6,2.584962500721156
brass,0,1,2,0.015208455666470933,2,1.0
bullet,1,1,0,-0.007751027598355844,1,0.0
stalls,0,1,1,0.007574867880211391,1,0.0
constantly,1,2,4,0.022783323546682326,5,2.321928094887362
sometimes,14,2,28,0.10598943041691133,42,5.392317422778761
close,13,2,9,-0.031356429829712276,22,4.459431618637297
stray,0,1,1,0.007574867880211391,1,0.0
evidence,4,3,0,-0.030827950675278923,4,2.0
body,3,3,3,-0.0002348796241926042,6,2.584962500721156
protective,0,2,1,0.007574867880211391,1,0.0
narc,3,2,8,0.03793305930710511,11,3.4594316186372978
bits,10,1,2,-0.061714621256606,12,3.5849625007211565
reads,1,2,0,-0.007751027598355844,1,0.0
d,20,1,17,-0.024133881385789785,37,5.20945336562895
handed,10,1,2,-0.061714621256606,12,3.5849625007211565
point,23,1,9,-0.1082795067527892,32,5.0
heavy,21,2,7,-0.10816206694069291,28,4.807354922057604
scrutiny,0,1,1,0.007574867880211391,1,0.0
auto,3,1,5,0.015032295948326481,8,3.0
dead,15,6,10,-0.03910745742806812,25,4.643856189774724
digs,0,1,3,0.022842043452730474,3,1.5849625007211563
blond,1,1,0,-0.007751027598355844,1,0.0
acting,27,2,26,-0.009277745155607753,53,5.7279204545632
private,5,4,2,-0.02325308279506753,7,2.807354922057604
pulled,2,1,0,-0.015443335290663537,2,1.0
delicate,1,1,3,0.015149735760422781,4,2.0
fancy,3,1,0,-0.02313564298297123,3,1.5849625007211563
administration,0,1,1,0.007574867880211391,1,0.0
nurses,1,1,0,-0.007751027598355844,1,0.0
hills,1,1,0,-0.007751027598355844,1,0.0
attempted,1,1,1,-0.0001174398120963021,2,1.0
puts,4,3,5,0.007339988256018788,9,3.1699250014423126
mom,2,1,1,-0.007809747504403995,3,1.5849625007211563
nickleby,3,1,6,0.022665883734586022,9,3.1699250014423126
separate,0,2,2,0.015208455666470933,2,1.0
venture,0,1,2,0.015208455666470933,2,1.0
enjoy,14,1,18,0.0296535525543159,32,5.0
cruel,2,1,2,-0.00017615971814445228,4,2.0
ralph,2,2,2,-0.00017615971814445228,4,2.0
nicholas,4,5,6,0.014973576042278329,10,3.3219280948873626
seek,0,3,1,0.007574867880211391,1,0.0
exploit,2,1,1,-0.007809747504403995,3,1.5849625007211563
feel,30,1,35,0.03634762184380505,65,6.022367813028454
develops,2,3,1,-0.007809747504403995,3,1.5849625007211563
photography,2,1,3,0.0074574280681150885,5,2.321928094887362
knowledge,2,1,0,-0.015443335290663537,2,1.0
expose,2,1,0,-0.015443335290663537,2,1.0
mart,2,1,0,-0.015443335290663537,2,1.0
development,2,1,4,0.015091015854374633,6,2.584962500721156
vast,2,1,1,-0.007809747504403995,3,1.5849625007211563
sy,0,3,2,0.015208455666470933,2,1.0
photo,1,1,6,0.03805049911920141,7,2.807354922057604
cost,1,1,1,-0.0001174398120963021,2,1.0
stanford,1,2,1,-0.0001174398120963021,2,1.0
orange,2,1,5,0.022724603640634174,7,2.807354922057604
lengths,0,1,1,0.007574867880211391,1,0.0
fit,7,2,7,-0.0004697592483852084,14,3.8073549220576037
surfer,1,1,2,0.0075161479741632405,3,1.5849625007211563
starting,1,2,2,0.0075161479741632405,3,1.5849625007211563
county,1,2,4,0.022783323546682326,5,2.321928094887362
loser,1,1,0,-0.007751027598355844,1,0.0
fighting,4,2,1,-0.023194362889019382,5,2.321928094887362
hide,5,1,2,-0.02325308279506753,7,2.807354922057604
designed,9,1,3,-0.046388725778038764,12,3.5849625007211565
panic,1,1,3,0.015149735760422781,4,2.0
hidden,1,1,3,0.015149735760422781,4,2.0
fairy,3,4,2,-0.007868467410452145,5,2.321928094887362
curious,0,1,1,0.007574867880211391,1,0.0
blue,12,1,13,0.00687022900763358,25,4.643856189774724
wooden,6,1,0,-0.04621256605989431,6,2.584962500721156
puppet,2,1,0,-0.015443335290663537,2,1.0
rival,0,1,1,0.007574867880211391,1,0.0
discovery,2,2,1,-0.007809747504403995,3,1.5849625007211563
shadow,2,1,1,-0.007809747504403995,3,1.5849625007211563
belonged,1,1,0,-0.007751027598355844,1,0.0
question,8,2,5,-0.023429242513211983,13,3.700439718141092
maud,0,1,1,0.007574867880211391,1,0.0
difficult,7,1,6,-0.00810334703464475,13,3.700439718141092
aid,2,2,1,-0.007809747504403995,3,1.5849625007211563
michell,4,2,1,-0.023194362889019382,5,2.321928094887362
roland,0,2,1,0.007574867880211391,1,0.0
expert,1,1,1,-0.0001174398120963021,2,1.0
wolfe,0,1,1,0.007574867880211391,1,0.0
textbook,2,1,1,-0.007809747504403995,3,1.5849625007211563
humanity,2,1,7,0.037991779213153255,9,3.1699250014423126
challenged,1,2,0,-0.007751027598355844,1,0.0
pumpkin,6,3,3,-0.023311802701115682,9,3.1699250014423126
games,3,1,3,-0.0002348796241926042,6,2.584962500721156
athletes,1,1,1,-0.0001174398120963021,2,1.0
sorority,5,2,3,-0.01561949500880799,8,3.0
mentally,2,1,0,-0.015443335290663537,2,1.0
seen,26,3,31,0.03658250146799763,57,5.832890014164742
touches,2,1,2,-0.00017615971814445228,4,2.0
horror,18,1,14,-0.031650029359953036,32,5.0
alpha,2,1,0,-0.015443335290663537,2,1.0
clarity,0,1,1,0.007574867880211391,1,0.0
terrified,0,1,1,0.007574867880211391,1,0.0
adam,5,1,4,-0.007985907222548445,9,3.1699250014423126
sandler,7,1,11,0.030064591896652962,18,4.169925001442312
kept,4,1,1,-0.023194362889019382,5,2.321928094887362
abuse,4,1,0,-0.030827950675278923,4,2.0
fall,4,1,3,-0.007927187316500297,7,2.807354922057604
unable,1,1,0,-0.007751027598355844,1,0.0
workers,0,1,1,0.007574867880211391,1,0.0
step,4,1,4,-0.00029359953024075264,8,3.0
landscape,3,1,3,-0.0002348796241926042,6,2.584962500721156
referred,2,1,0,-0.015443335290663537,2,1.0
mothers,0,1,1,0.007574867880211391,1,0.0
molly,0,2,2,0.015208455666470933,2,1.0
daring,3,1,7,0.030299471520845563,10,3.3219280948873626
500,0,2,1,0.007574867880211391,1,0.0
ahead,2,2,5,0.022724603640634174,7,2.807354922057604
across,6,4,3,-0.023311802701115682,9,3.1699250014423126
domestic,4,2,1,-0.023194362889019382,5,2.321928094887362
survive,3,3,2,-0.007868467410452145,5,2.321928094887362
rabbit,1,2,5,0.030416911332941866,6,2.584962500721156
guide,1,1,1,-0.0001174398120963021,2,1.0
miles,0,2,2,0.015208455666470933,2,1.0
generations,1,1,3,0.015149735760422781,4,2.0
fence,3,2,7,0.030299471520845563,10,3.3219280948873626
grit,1,1,0,-0.007751027598355844,1,0.0
determination,1,2,4,0.022783323546682326,5,2.321928094887362
proof,4,2,6,0.014973576042278329,10,3.3219280948873626
today,5,1,9,0.030182031708749266,14,3.8073549220576037
impossible,9,1,9,-0.0005871990604815053,18,4.169925001442312
ingenuity,2,1,0,-0.015443335290663537,2,1.0
spirited,3,3,4,0.00739870816206694,7,2.807354922057604
cousin,1,1,1,-0.0001174398120963021,2,1.0
denied,2,1,0,-0.015443335290663537,2,1.0
none,16,2,5,-0.08496770405167353,21,4.392317422778761
fatal,12,1,2,-0.07709923664122138,14,3.8073549220576037
above,6,1,22,0.1217263652378156,28,4.807354922057604
asks,2,1,4,0.015091015854374633,6,2.584962500721156
lecter,1,4,1,-0.0001174398120963021,2,1.0
problem,20,3,4,-0.12337052260716383,24,4.584962500721157
norton,1,1,4,0.022783323546682326,5,2.321928094887362
image,2,1,3,0.0074574280681150885,5,2.321928094887362
tangled,0,1,1,0.007574867880211391,1,0.0
pure,5,1,14,0.06834997064004697,19,4.247927513443585
dragon,1,1,13,0.0914856136230182,14,3.8073549220576037
marked,0,1,2,0.015208455666470933,2,1.0
atrocious,1,1,0,-0.007751027598355844,1,0.0
nemesis,5,1,3,-0.01561949500880799,8,3.0
graham,0,7,3,0.022842043452730474,3,1.5849625007211563
tooth,1,3,1,-0.0001174398120963021,2,1.0
sacrificing,0,1,1,0.007574867880211391,1,0.0
hannibal,2,4,6,0.030358191426893714,8,3.0
3,4,2,1,-0.023194362889019382,5,2.321928094887362
red,3,1,12,0.06846741045214327,15,3.9068905956085187
scars,0,1,2,0.015208455666470933,2,1.0
weeks,2,1,4,0.015091015854374633,6,2.584962500721156
exciting,10,1,9,-0.008279506752789198,19,4.247927513443585
century,2,1,6,0.030358191426893714,8,3.0
reign,7,1,8,0.007163828537874339,15,3.9068905956085187
x,1,3,5,0.030416911332941866,6,2.584962500721156
mankind,0,1,1,0.007574867880211391,1,0.0
says,2,1,1,-0.007809747504403995,3,1.5849625007211563
inadvertently,1,1,1,-0.0001174398120963021,2,1.0
slumber,1,1,0,-0.007751027598355844,1,0.0
quinn,1,3,1,-0.0001174398120963021,2,1.0
matthew,3,2,1,-0.015502055196711688,4,2.0
fuses,0,1,1,0.007574867880211391,1,0.0
eke,1,1,0,-0.007751027598355844,1,0.0
meager,1,1,0,-0.007751027598355844,1,0.0
done,21,3,15,-0.04709336465061657,36,5.169925001442312
much,112,8,87,-0.0584850264239577,199,7.636624620543649
mcconaughey,3,1,0,-0.02313564298297123,3,1.5849625007211563
breathing,1,1,2,0.0075161479741632405,3,1.5849625007211563
fire,16,4,10,-0.046799765120375814,26,4.700439718141093
beast,0,2,1,0.007574867880211391,1,0.0
enormous,0,1,3,0.022842043452730474,3,1.5849625007211563
chief,0,2,3,0.022842043452730474,3,1.5849625007211563
rob,1,2,2,0.0075161479741632405,3,1.5849625007211563
christian,3,1,2,-0.007868467410452145,5,2.321928094887362
lab,2,2,0,-0.015443335290663537,2,1.0
releasing,1,2,1,-0.0001174398120963021,2,1.0
memories,3,1,6,0.022665883734586022,9,3.1699250014423126
mile,5,1,10,0.037815619495008806,15,3.9068905956085187
alice,0,3,3,0.022842043452730474,3,1.5849625007211563
jovovich,1,1,0,-0.007751027598355844,1,0.0
virus,1,5,0,-0.007751027598355844,1,0.0
force,1,4,7,0.04568408690546095,8,3.0
half,27,2,14,-0.10088079859072227,41,5.357552004618084
task,1,2,2,0.0075161479741632405,3,1.5849625007211563
released,4,1,0,-0.030827950675278923,4,2.0
rain,1,1,1,-0.0001174398120963021,2,1.0
couldn,3,1,7,0.030299471520845563,10,3.3219280948873626
gas,1,2,2,0.0075161479741632405,3,1.5849625007211563
largest,0,1,1,0.007574867880211391,1,0.0
returning,1,1,1,-0.0001174398120963021,2,1.0
contain,1,2,0,-0.007751027598355844,1,0.0
zombies,1,3,0,-0.007751027598355844,1,0.0
medical,1,2,2,0.0075161479741632405,3,1.5849625007211563
researchers,1,1,0,-0.007751027598355844,1,0.0
research,0,1,2,0.015208455666470933,2,1.0
nerve,1,2,6,0.03805049911920141,7,2.807354922057604
rodriguez,3,1,6,0.022665883734586022,9,3.1699250014423126
suffering,1,1,4,0.022783323546682326,5,2.321928094887362
shut,1,2,2,0.0075161479741632405,3,1.5849625007211563
hook,4,1,1,-0.023194362889019382,5,2.321928094887362
give,12,3,14,0.01450381679389312,26,4.700439718141093
magical,1,1,2,0.0075161479741632405,3,1.5849625007211563
mistakes,1,1,1,-0.0001174398120963021,2,1.0
telling,3,1,8,0.03793305930710511,11,3.4594316186372978
tales,4,1,1,-0.023194362889019382,5,2.321928094887362
magic,6,1,14,0.06065766294773928,20,4.321928094887363
safely,0,1,1,0.007574867880211391,1,0.0
capture,0,3,1,0.007574867880211391,1,0.0
imagination,9,1,8,-0.008220786846741046,17,4.08746284125034
disney,13,1,16,0.02207868467410451,29,4.857980995127573
pan,1,4,3,0.015149735760422781,4,2.0
peter,4,11,6,0.014973576042278329,10,3.3219280948873626
jane,1,3,2,0.0075161479741632405,3,1.5849625007211563
witnessed,1,1,0,-0.007751027598355844,1,0.0
devoted,1,1,0,-0.007751027598355844,1,0.0
startling,0,2,1,0.007574867880211391,1,0.0
surviving,2,1,0,-0.015443335290663537,2,1.0
sullivan,0,11,1,0.007574867880211391,1,0.0
boys,8,2,5,-0.023429242513211983,13,3.700439718141092
stars,11,3,9,-0.01597181444509689,20,4.321928094887363
sedate,0,1,1,0.007574867880211391,1,0.0
alike,0,1,2,0.015208455666470933,2,1.0
taking,4,1,10,0.0455079271873165,14,3.8073549220576037
angel,1,1,0,-0.007751027598355844,1,0.0
boss,1,5,0,-0.007751027598355844,1,0.0
co,4,2,3,-0.007927187316500297,7,2.807354922057604
era,7,2,10,0.02243100411039342,17,4.08746284125034
mob,1,2,0,-0.007751027598355844,1,0.0
figure,5,2,3,-0.01561949500880799,8,3.0
embark,0,1,1,0.007574867880211391,1,0.0
maguire,0,1,4,0.03047563123899002,4,2.0
hanks,2,2,3,0.0074574280681150885,5,2.321928094887362
depression,2,1,1,-0.007809747504403995,3,1.5849625007211563
roger,4,4,9,0.03787433940105696,13,3.700439718141092
hopelessly,1,1,0,-0.007751027598355844,1,0.0
teenager,0,1,1,0.007574867880211391,1,0.0
sharp,6,2,12,0.045390487375220195,18,4.169925001442312
adult,3,1,10,0.05320023487962419,13,3.700439718141092
paid,4,1,2,-0.015560775102759838,6,2.584962500721156
singles,0,1,2,0.015208455666470933,2,1.0
visit,2,2,2,-0.00017615971814445228,4,2.0
ego,0,1,1,0.007574867880211391,1,0.0
begs,2,1,0,-0.015443335290663537,2,1.0
nephew,0,1,1,0.007574867880211391,1,0.0
razor,0,1,1,0.007574867880211391,1,0.0
swanson,0,1,1,0.007574867880211391,1,0.0
issue,4,1,1,-0.023194362889019382,5,2.321928094887362
advertising,1,1,0,-0.007751027598355844,1,0.0
field,1,2,1,-0.0001174398120963021,2,1.0
pleasure,5,1,12,0.05308279506752789,17,4.08746284125034
players,1,2,3,0.015149735760422781,4,2.0
petrovich,1,2,0,-0.007751027598355844,1,0.0
metal,4,1,0,-0.030827950675278923,4,2.0
viewers,8,1,15,0.05290663534938343,23,4.523561956057013
yes,5,1,5,-0.00035231943628890455,10,3.3219280948873626
mere,6,1,1,-0.03857897827363477,7,2.807354922057604
oh,5,1,3,-0.01561949500880799,8,3.0
ball,3,1,3,-0.0002348796241926042,6,2.584962500721156
goal,2,1,1,-0.007809747504403995,3,1.5849625007211563
momentum,0,1,1,0.007574867880211391,1,0.0
audience,44,1,32,-0.09424544920728128,76,6.247927513443586
invention,3,1,0,-0.02313564298297123,3,1.5849625007211563
ropes,1,1,0,-0.007751027598355844,1,0.0
rollerball,8,2,1,-0.05396359365825015,9,3.1699250014423126
cause,6,2,3,-0.023311802701115682,9,3.1699250014423126
cannot,8,2,2,-0.04633000587199061,10,3.3219280948873626
desperate,3,1,1,-0.015502055196711688,4,2.0
admit,2,1,5,0.022724603640634174,7,2.807354922057604
believable,3,1,7,0.030299471520845563,10,3.3219280948873626
simone,3,2,4,0.00739870816206694,7,2.807354922057604
create,6,1,6,-0.00041103934233705647,12,3.5849625007211565
actress,3,3,4,0.00739870816206694,7,2.807354922057604
bear,1,1,0,-0.007751027598355844,1,0.0
totally,5,1,2,-0.02325308279506753,7,2.807354922057604
leaving,4,1,1,-0.023194362889019382,5,2.321928094887362
inc,2,2,1,-0.007809747504403995,3,1.5849625007211563
daphne,1,2,0,-0.007751027598355844,1,0.0
owned,0,1,2,0.015208455666470933,2,1.0
shaggy,2,2,2,-0.00017615971814445228,4,2.0
others,2,1,10,0.060892542571931885,12,3.5849625007211565
scooby,6,2,5,-0.008044627128596597,11,3.4594316186372978
mysteriously,0,2,1,0.007574867880211391,1,0.0
amusement,1,1,0,-0.007751027598355844,1,0.0
figuring,0,2,1,0.007574867880211391,1,0.0
receive,1,1,0,-0.007751027598355844,1,0.0
theme,3,1,5,0.015032295948326481,8,3.0
park,2,2,0,-0.015443335290663537,2,1.0
doo,2,1,3,0.0074574280681150885,5,2.321928094887362
spooky,1,2,3,0.015149735760422781,4,2.0
sober,1,1,0,-0.007751027598355844,1,0.0
affirmation,0,1,1,0.007574867880211391,1,0.0
brief,0,1,3,0.022842043452730474,3,1.5849625007211563
grey,1,1,0,-0.007751027598355844,1,0.0
quirky,8,1,9,0.0071051086318261875,17,4.08746284125034
heights,2,1,0,-0.015443335290663537,2,1.0
lee,1,4,6,0.03805049911920141,7,2.807354922057604
secretary,1,1,11,0.07621843805049912,12,3.5849625007211565
crush,10,1,8,-0.01591309453904874,18,4.169925001442312
relief,0,1,3,0.022842043452730474,3,1.5849625007211563
masochism,1,1,0,-0.007751027598355844,1,0.0
environment,1,2,1,-0.0001174398120963021,2,1.0
developing,1,1,0,-0.007751027598355844,1,0.0
nerdy,2,2,0,-0.015443335290663537,2,1.0
deepest,0,1,2,0.015208455666470933,2,1.0
served,5,1,4,-0.007985907222548445,9,3.1699250014423126
divorce,1,3,0,-0.007751027598355844,1,0.0
hurley,4,1,0,-0.030827950675278923,4,2.0
stunned,0,1,1,0.007574867880211391,1,0.0
elizabeth,3,1,1,-0.015502055196711688,4,2.0
sara,8,1,0,-0.061597181444509694,8,3.0
fortune,2,1,1,-0.007809747504403995,3,1.5849625007211563
lose,1,1,0,-0.007751027598355844,1,0.0
serving,9,1,1,-0.061655901350557846,10,3.3219280948873626
perry,5,2,0,-0.038520258367586616,5,2.321928094887362
camera,5,2,9,0.030182031708749266,14,3.8073549220576037
possesses,0,1,2,0.015208455666470933,2,1.0
refused,1,1,0,-0.007751027598355844,1,0.0
botched,2,1,0,-0.015443335290663537,2,1.0
friendly,4,1,2,-0.015560775102759838,6,2.584962500721156
automatic,0,1,1,0.007574867880211391,1,0.0
faced,2,2,3,0.0074574280681150885,5,2.321928094887362
stereotypical,2,1,1,-0.007809747504403995,3,1.5849625007211563
mounted,3,1,0,-0.02313564298297123,3,1.5849625007211563
exotic,0,1,1,0.007574867880211391,1,0.0
trend,1,1,1,-0.0001174398120963021,2,1.0
collapse,1,1,0,-0.007751027598355844,1,0.0
viewer,11,1,9,-0.01597181444509689,20,4.321928094887363
shares,1,3,1,-0.0001174398120963021,2,1.0
throughout,2,3,11,0.06852613035819143,13,3.700439718141092
mugging,2,1,0,-0.015443335290663537,2,1.0
cares,2,1,3,0.0074574280681150885,5,2.321928094887362
10,7,3,3,-0.031004110393423375,10,3.3219280948873626
calling,1,3,0,-0.007751027598355844,1,0.0
especially,6,2,19,0.098825601879037,25,4.643856189774724
renee,0,1,1,0.007574867880211391,1,0.0
whether,10,3,7,-0.023546682325308287,17,4.08746284125034
russo,0,1,1,0.007574867880211391,1,0.0
truth,6,1,11,0.037756899588960655,17,4.08746284125034
hundred,2,1,0,-0.015443335290663537,2,1.0
foot,3,1,0,-0.02313564298297123,3,1.5849625007211563
faith,2,1,2,-0.00017615971814445228,4,2.0
gibson,1,2,5,0.030416911332941866,6,2.584962500721156
circle,1,2,2,0.0075161479741632405,3,1.5849625007211563
circles,1,2,0,-0.007751027598355844,1,0.0
bucks,3,1,2,-0.007868467410452145,5,2.321928094887362
frenzy,1,1,0,-0.007751027598355844,1,0.0
farm,2,1,0,-0.015443335290663537,2,1.0
mogie,0,1,1,0.007574867880211391,1,0.0
ongoing,1,1,1,-0.0001174398120963021,2,1.0
inhabitants,1,1,0,-0.007751027598355844,1,0.0
norm,0,1,1,0.007574867880211391,1,0.0
largely,8,1,6,-0.015795654726952442,14,3.8073549220576037
native,0,2,4,0.03047563123899002,4,2.0
destruction,0,3,1,0.007574867880211391,1,0.0
millions,2,1,0,-0.015443335290663537,2,1.0
alcoholism,0,1,1,0.007574867880211391,1,0.0
reservation,0,1,2,0.015208455666470933,2,1.0
store,4,1,3,-0.007927187316500297,7,2.807354922057604
rudy,0,3,1,0.007574867880211391,1,0.0
cycle,1,1,0,-0.007751027598355844,1,0.0
despair,2,1,3,0.0074574280681150885,5,2.321928094887362
honors,1,1,1,-0.0001174398120963021,2,1.0
lying,1,1,2,0.0075161479741632405,3,1.5849625007211563
dude,2,1,1,-0.007809747504403995,3,1.5849625007211563
cheating,1,2,0,-0.007751027598355844,1,0.0
graduate,0,3,2,0.015208455666470933,2,1.0
jeff,0,1,1,0.007574867880211391,1,0.0
student,4,4,0,-0.030827950675278923,4,2.0
beings,0,1,3,0.022842043452730474,3,1.5849625007211563
response,2,1,1,-0.007809747504403995,3,1.5849625007211563
french,3,3,2,-0.007868467410452145,5,2.321928094887362
fail,3,1,0,-0.02313564298297123,3,1.5849625007211563
poor,6,1,2,-0.030945390487375223,8,3.0
exchange,1,1,1,-0.0001174398120963021,2,1.0
deliberately,1,1,1,-0.0001174398120963021,2,1.0
foreign,1,1,0,-0.007751027598355844,1,0.0
attractive,1,1,2,0.0075161479741632405,3,1.5849625007211563
head,11,1,13,0.014562536699941273,24,4.584962500721157
exactly,14,2,17,0.02201996476805637,31,4.954196310386876
stealing,11,1,0,-0.08467410452143277,11,3.4594316186372978
genevieve,1,5,0,-0.007751027598355844,1,0.0
type,7,1,2,-0.03863769817968292,9,3.1699250014423126
james,7,1,8,0.007163828537874339,15,3.9068905956085187
gooding,2,1,3,0.0074574280681150885,5,2.321928094887362
receives,0,1,1,0.007574867880211391,1,0.0
detailing,0,1,1,0.007574867880211391,1,0.0
dogs,7,5,2,-0.03863769817968292,9,3.1699250014423126
dentist,1,1,0,-0.007751027598355844,1,0.0
coburn,1,1,0,-0.007751027598355844,1,0.0
sled,0,2,1,0.007574867880211391,1,0.0
ted,1,5,0,-0.007751027598355844,1,0.0
rowdy,2,2,0,-0.015443335290663537,2,1.0
mountain,1,1,1,-0.0001174398120963021,2,1.0
pack,1,1,1,-0.0001174398120963021,2,1.0
chunk,0,1,2,0.015208455666470933,2,1.0
solaris,5,1,7,0.014914856136230177,12,3.5849625007211565
commander,0,1,1,0.007574867880211391,1,0.0
space,4,4,4,-0.00029359953024075264,8,3.0
orleans,0,1,1,0.007574867880211391,1,0.0
army,1,5,0,-0.007751027598355844,1,0.0
sonny,2,1,2,-0.00017615971814445228,4,2.0
promised,1,1,1,-0.0001174398120963021,2,1.0
buddy,5,2,3,-0.01561949500880799,8,3.0
1981,0,1,1,0.007574867880211391,1,0.0
frat,3,3,0,-0.02313564298297123,3,1.5849625007211563
grab,3,1,3,-0.0002348796241926042,6,2.584962500721156
ugly,12,1,4,-0.061832061068702295,16,4.0
catcher,1,1,0,-0.007751027598355844,1,0.0
guys,6,2,7,0.007222548443922484,13,3.700439718141092
dog,13,1,6,-0.054257193188490906,19,4.247927513443585
earn,3,1,2,-0.007868467410452145,5,2.321928094887362
mentality,2,1,0,-0.015443335290663537,2,1.0
stunning,1,2,4,0.022783323546682326,5,2.321928094887362
invite,1,1,1,-0.0001174398120963021,2,1.0
party,4,1,2,-0.015560775102759838,6,2.584962500721156
female,3,1,4,0.00739870816206694,7,2.807354922057604
right,30,1,41,0.08214914856136227,71,6.149747119504682
norman,1,2,0,-0.007751027598355844,1,0.0
bitten,1,1,0,-0.007751027598355844,1,0.0
failed,2,2,1,-0.007809747504403995,3,1.5849625007211563
personality,5,1,0,-0.038520258367586616,5,2.321928094887362
chemistry,8,1,7,-0.008162066940692901,15,3.9068905956085187
occurred,0,1,1,0.007574867880211391,1,0.0
approaching,2,1,0,-0.015443335290663537,2,1.0
handle,2,2,2,-0.00017615971814445228,4,2.0
experimental,1,1,1,-0.0001174398120963021,2,1.0
scale,2,2,1,-0.007809747504403995,3,1.5849625007211563
radioactive,0,1,1,0.007574867880211391,1,0.0
green,13,3,3,-0.07715795654726954,16,4.0
mary,2,1,0,-0.015443335290663537,2,1.0
spider,3,4,13,0.07610099823840281,16,4.0
edge,3,1,9,0.04556664709336465,12,3.5849625007211565
giggles,0,1,1,0.007574867880211391,1,0.0
juni,0,1,2,0.015208455666470933,2,1.0
carmen,0,1,2,0.015208455666470933,2,1.0
romero,1,1,0,-0.007751027598355844,1,0.0
gary,2,1,0,-0.015443335290663537,2,1.0
buscemi,0,1,1,0.007574867880211391,1,0.0
cortez,0,1,1,0.007574867880211391,1,0.0
closely,1,1,1,-0.0001174398120963021,2,1.0
simply,16,1,15,-0.00863182618907811,31,4.954196310386876
ed,2,1,0,-0.015443335290663537,2,1.0
pretty,31,1,19,-0.09348209042865532,50,5.643856189774724
closer,3,1,4,0.00739870816206694,7,2.807354922057604
standing,1,3,3,0.015149735760422781,4,2.0
astounding,1,1,1,-0.0001174398120963021,2,1.0
unabashed,0,1,2,0.015208455666470933,2,1.0
smarter,1,1,8,0.053317674691720496,9,3.1699250014423126
prefabricated,1,1,0,-0.007751027598355844,1,0.0
engrossing,0,1,8,0.06100998238402819,8,3.0
inherent,1,1,4,0.022783323546682326,5,2.321928094887362
simultaneously,2,1,1,-0.007809747504403995,3,1.5849625007211563
tightly,0,1,3,0.022842043452730474,3,1.5849625007211563
strip,0,1,1,0.007574867880211391,1,0.0
filmmakers,20,1,14,-0.04703464474456842,34,5.08746284125034
daily,0,2,3,0.022842043452730474,3,1.5849625007211563
machinations,0,1,1,0.007574867880211391,1,0.0
shame,4,1,2,-0.015560775102759838,6,2.584962500721156
dreck,3,1,0,-0.02313564298297123,3,1.5849625007211563
subjects,1,2,1,-0.0001174398120963021,2,1.0
devastating,1,1,1,-0.0001174398120963021,2,1.0
reminds,0,1,3,0.022842043452730474,3,1.5849625007211563
uncomfortably,0,1,1,0.007574867880211391,1,0.0
rip,7,1,5,-0.01573693482090429,12,3.5849625007211565
honesty,1,1,3,0.015149735760422781,4,2.0
yourself,4,2,8,0.030240751614797418,12,3.5849625007211565
unforgettable,0,1,1,0.007574867880211391,1,0.0
stones,0,1,2,0.015208455666470933,2,1.0
classics,0,1,2,0.015208455666470933,2,1.0
archival,0,1,1,0.007574867880211391,1,0.0
tell,15,1,9,-0.04674104521432766,24,4.584962500721157
motown,0,4,6,0.0457428068115091,6,2.584962500721156
heartbeat,0,1,2,0.015208455666470933,2,1.0
note,3,1,3,-0.0002348796241926042,6,2.584962500721156
phenomenal,0,1,4,0.03047563123899002,4,2.0
jazz,1,1,2,0.0075161479741632405,3,1.5849625007211563
performers,2,1,2,-0.00017615971814445228,4,2.0
musicians,1,2,5,0.030416911332941866,6,2.584962500721156
creation,2,1,6,0.030358191426893714,8,3.0
ones,4,1,6,0.014973576042278329,10,3.3219280948873626
fourteen,0,1,1,0.007574867880211391,1,0.0
machine,3,1,0,-0.02313564298297123,3,1.5849625007211563
berry,0,1,2,0.015208455666470933,2,1.0
backing,0,1,1,0.007574867880211391,1,0.0
combined,0,1,4,0.03047563123899002,4,2.0
funk,0,2,4,0.03047563123899002,4,2.0
period,5,1,5,-0.00035231943628890455,10,3.3219280948873626
material,23,1,17,-0.04721080446271286,40,5.321928094887363
enterprise,2,3,2,-0.00017615971814445228,4,2.0
cloaked,1,1,0,-0.007751027598355844,1,0.0
systems,0,1,1,0.007574867880211391,1,0.0
battling,0,1,1,0.007574867880211391,1,0.0
appears,12,1,1,-0.08473282442748092,13,3.700439718141092
talks,1,1,0,-0.007751027598355844,1,0.0
wars,4,1,7,0.02260716382853787,11,3.4594316186372978
code,2,1,3,0.0074574280681150885,5,2.321928094887362
protect,1,4,1,-0.0001174398120963021,2,1.0
perhaps,8,1,9,0.0071051086318261875,17,4.08746284125034
ensure,0,1,1,0.007574867880211391,1,0.0
anakin,0,7,1,0.007574867880211391,1,0.0
aren,8,1,4,-0.031062830299471524,12,3.5849625007211565
rebel,0,1,1,0.007574867880211391,1,0.0
movement,0,1,1,0.007574867880211391,1,0.0
slipping,0,1,1,0.007574867880211391,1,0.0
natalie,1,1,0,-0.007751027598355844,1,0.0
tracking,1,1,0,-0.007751027598355844,1,0.0
elusive,1,1,0,-0.007751027598355844,1,0.0
fears,0,1,2,0.015208455666470933,2,1.0
massive,1,1,2,0.0075161479741632405,3,1.5849625007211563
clone,1,2,1,-0.0001174398120963021,2,1.0
saga,2,1,4,0.015091015854374633,6,2.584962500721156
produced,5,1,3,-0.01561949500880799,8,3.0
promises,1,1,4,0.022783323546682326,5,2.321928094887362
matter,14,1,18,0.0296535525543159,32,5.0
grows,3,2,2,-0.007868467410452145,5,2.321928094887362
phantom,2,2,0,-0.015443335290663537,2,1.0
send,5,1,3,-0.01561949500880799,8,3.0
menace,3,2,2,-0.007868467410452145,5,2.321928094887362
wan,1,7,0,-0.007751027598355844,1,0.0
cardellini,1,1,0,-0.007751027598355844,1,0.0
lonely,0,1,4,0.03047563123899002,4,2.0
nowhere,7,1,2,-0.03863769817968292,9,3.1699250014423126
george,7,4,6,-0.00810334703464475,13,3.700439718141092
covers,2,1,2,-0.00017615971814445228,4,2.0
falcon,0,1,1,0.007574867880211391,1,0.0
lie,2,2,2,-0.00017615971814445228,4,2.0
stuart,5,5,7,0.014914856136230177,12,3.5849625007211565
mermaid,1,1,2,0.0075161479741632405,3,1.5849625007211563
portrait,1,1,16,0.11438637698179682,17,4.08746284125034
wrestle,1,1,0,-0.007751027598355844,1,0.0
duty,1,2,2,0.0075161479741632405,3,1.5849625007211563
weight,3,1,1,-0.015502055196711688,4,2.0
broadway,1,1,2,0.0075161479741632405,3,1.5849625007211563
conspire,1,1,0,-0.007751027598355844,1,0.0
limited,4,1,1,-0.023194362889019382,5,2.321928094887362
responsibility,0,1,1,0.007574867880211391,1,0.0
aquatic,1,1,0,-0.007751027598355844,1,0.0
nightmare,3,2,1,-0.015502055196711688,4,2.0
expectations,3,1,8,0.03793305930710511,11,3.4594316186372978
formidable,1,1,0,-0.007751027598355844,1,0.0
steve,0,1,3,0.022842043452730474,3,1.5849625007211563
concerning,1,1,0,-0.007751027598355844,1,0.0
15,3,2,4,0.00739870816206694,7,2.807354922057604
questions,2,1,9,0.053258954785672344,11,3.4594316186372978
grapple,1,1,0,-0.007751027598355844,1,0.0
independent,2,1,2,-0.00017615971814445228,4,2.0
overwhelming,0,1,3,0.022842043452730474,3,1.5849625007211563
vibrant,1,1,4,0.022783323546682326,5,2.321928094887362
bound,2,1,0,-0.015443335290663537,2,1.0
alabama,4,1,7,0.02260716382853787,11,3.4594316186372978
sneaks,0,1,1,0.007574867880211391,1,0.0
fashion,3,1,1,-0.015502055196711688,4,2.0
redneck,0,1,2,0.015208455666470933,2,1.0
carmichael,0,1,1,0.007574867880211391,1,0.0
melanie,1,3,1,-0.0001174398120963021,2,1.0
arrogant,2,1,0,-0.015443335290663537,2,1.0
frills,0,1,1,0.007574867880211391,1,0.0
passive,0,1,1,0.007574867880211391,1,0.0
tony,3,2,1,-0.015502055196711688,4,2.0
madonna,11,1,4,-0.0541397533763946,15,3.9068905956085187
wealthy,0,2,1,0.007574867880211391,1,0.0
beyond,7,2,10,0.02243100411039342,17,4.08746284125034
amber,1,2,0,-0.007751027598355844,1,0.0
giannini,1,1,0,-0.007751027598355844,1,0.0
measure,1,1,2,0.0075161479741632405,3,1.5849625007211563
betrayal,0,1,1,0.007574867880211391,1,0.0
pool,4,1,0,-0.030827950675278923,4,2.0
quality,6,1,11,0.037756899588960655,17,4.08746284125034
promising,6,1,2,-0.030945390487375223,8,3.0
sights,0,1,1,0.007574867880211391,1,0.0
swim,2,1,1,-0.007809747504403995,3,1.5849625007211563
fan,2,1,11,0.06852613035819143,13,3.700439718141092
critical,4,1,2,-0.015560775102759838,6,2.584962500721156
terrific,3,1,16,0.09900176159718144,19,4.247927513443585
spiral,0,1,2,0.015208455666470933,2,1.0
solid,5,1,22,0.1294186729301233,27,4.754887502163469
academy,2,1,1,-0.007809747504403995,3,1.5849625007211563
distraction,1,1,1,-0.0001174398120963021,2,1.0
speaks,0,1,4,0.03047563123899002,4,2.0
obsessed,0,2,2,0.015208455666470933,2,1.0
comfort,1,1,2,0.0075161479741632405,3,1.5849625007211563
scarf,1,1,0,-0.007751027598355844,1,0.0
fills,2,1,2,-0.00017615971814445228,4,2.0
certain,6,1,8,0.014856136230182032,14,3.8073549220576037
could,50,2,37,-0.09453904873752206,87,6.442943495848729
thanksgiving,2,1,0,-0.015443335290663537,2,1.0
resolution,0,1,1,0.007574867880211391,1,0.0
stepmother,0,1,1,0.007574867880211391,1,0.0
passionate,1,1,5,0.030416911332941866,6,2.584962500721156
oscar,5,7,14,0.06834997064004697,19,4.247927513443585
sensitive,1,1,4,0.022783323546682326,5,2.321928094887362
wearing,1,1,0,-0.007751027598355844,1,0.0
diane,2,3,7,0.037991779213153255,9,3.1699250014423126
borrowed,2,1,0,-0.015443335290663537,2,1.0
void,4,1,0,-0.030827950675278923,4,2.0
conviction,2,1,4,0.015091015854374633,6,2.584962500721156
say,21,2,17,-0.03182618907809748,38,5.247927513443585
twice,4,1,4,-0.00029359953024075264,8,3.0
sources,4,1,0,-0.030827950675278923,4,2.0
bundy,1,1,0,-0.007751027598355844,1,0.0
execution,7,1,5,-0.01573693482090429,12,3.5849625007211565
least,15,1,16,0.006694069289489124,31,4.954196310386876
19,4,1,8,0.030240751614797418,12,3.5849625007211565
seduction,0,1,1,0.007574867880211391,1,0.0
recipe,0,1,2,0.015208455666470933,2,1.0
anxious,1,1,1,-0.0001174398120963021,2,1.0
fulfill,0,1,2,0.015208455666470933,2,1.0
artificial,4,1,1,-0.023194362889019382,5,2.321928094887362
bio,0,2,4,0.03047563123899002,4,2.0
puzzled,1,1,0,-0.007751027598355844,1,0.0
gender,0,1,2,0.015208455666470933,2,1.0
acts,3,2,2,-0.007868467410452145,5,2.321928094887362
distinguish,3,1,0,-0.02313564298297123,3,1.5849625007211563
absorbs,1,1,0,-0.007751027598355844,1,0.0
reproduce,1,1,0,-0.007751027598355844,1,0.0
xerox,1,1,0,-0.007751027598355844,1,0.0
longer,5,1,4,-0.007985907222548445,9,3.1699250014423126
breed,1,1,1,-0.0001174398120963021,2,1.0
projects,2,1,0,-0.015443335290663537,2,1.0
improve,3,1,1,-0.015502055196711688,4,2.0
marine,2,2,0,-0.015443335290663537,2,1.0
populated,0,1,1,0.007574867880211391,1,0.0
touch,5,2,3,-0.01561949500880799,8,3.0
regan,1,1,0,-0.007751027598355844,1,0.0
event,3,1,4,0.00739870816206694,7,2.807354922057604
realization,0,1,1,0.007574867880211391,1,0.0
laura,1,1,1,-0.0001174398120963021,2,1.0
worse,13,1,3,-0.07715795654726954,16,4.0
psychology,1,1,0,-0.007751027598355844,1,0.0
ransom,1,1,0,-0.007751027598355844,1,0.0
stevenson,1,1,5,0.030416911332941866,6,2.584962500721156
charismatic,0,1,2,0.015208455666470933,2,1.0
cabin,1,1,0,-0.007751027598355844,1,0.0
hole,2,1,0,-0.015443335290663537,2,1.0
robert,14,1,9,-0.03904873752201997,23,4.523561956057013
majestic,0,1,1,0.007574867880211391,1,0.0
universe,0,1,2,0.015208455666470933,2,1.0
fine,9,1,12,0.022313564298297117,21,4.392317422778761
ferocious,0,1,1,0.007574867880211391,1,0.0
louis,3,1,1,-0.015502055196711688,4,2.0
silver,2,2,4,0.015091015854374633,6,2.584962500721156
treasure,6,2,8,0.014856136230182032,14,3.8073549220576037
fantastic,2,1,3,0.0074574280681150885,5,2.321928094887362
jim,0,3,1,0.007574867880211391,1,0.0
everlasting,4,1,3,-0.007927187316500297,7,2.807354922057604
tuck,4,2,3,-0.007927187316500297,7,2.807354922057604
stuffy,1,1,0,-0.007751027598355844,1,0.0
till,2,1,1,-0.007809747504403995,3,1.5849625007211563
stumbles,1,1,2,0.0075161479741632405,3,1.5849625007211563
shouldn,3,1,2,-0.007868467410452145,5,2.321928094887362
hiding,1,1,0,-0.007751027598355844,1,0.0
disappears,0,1,1,0.007574867880211391,1,0.0
importance,0,1,6,0.0457428068115091,6,2.584962500721156
spring,2,3,1,-0.007809747504403995,3,1.5849625007211563
strategic,0,1,1,0.007574867880211391,1,0.0
neurotic,0,1,2,0.015208455666470933,2,1.0
developers,0,1,1,0.007574867880211391,1,0.0
shots,5,1,1,-0.030886670581327075,6,2.584962500721156
treats,1,1,2,0.0075161479741632405,3,1.5849625007211563
undeniably,0,1,2,0.015208455666470933,2,1.0
fabulously,0,1,1,0.007574867880211391,1,0.0
explores,0,1,2,0.015208455666470933,2,1.0
barely,8,1,2,-0.04633000587199061,10,3.3219280948873626
charming,4,2,16,0.09130945390487374,20,4.321928094887363
sleep,4,1,1,-0.023194362889019382,5,2.321928094887362
clothes,3,1,0,-0.02313564298297123,3,1.5849625007211563
grad,1,1,0,-0.007751027598355844,1,0.0
transformation,0,1,1,0.007574867880211391,1,0.0
levels,5,1,5,-0.00035231943628890455,10,3.3219280948873626
devil,0,1,1,0.007574867880211391,1,0.0
perpetrators,1,1,0,-0.007751027598355844,1,0.0
attitude,1,3,6,0.03805049911920141,7,2.807354922057604
sassy,1,1,1,-0.0001174398120963021,2,1.0
snow,9,1,4,-0.038755137991779216,13,3.700439718141092
trade,2,1,0,-0.015443335290663537,2,1.0
harmless,7,1,3,-0.031004110393423375,10,3.3219280948873626
undergo,1,1,0,-0.007751027598355844,1,0.0
undisputed,3,1,5,0.015032295948326481,8,3.0
snipes,0,1,3,0.022842043452730474,3,1.5849625007211563
rape,1,1,0,-0.007751027598355844,1,0.0
monroe,1,1,0,-0.007751027598355844,1,0.0
rhames,0,1,2,0.015208455666470933,2,1.0
falk,0,1,1,0.007574867880211391,1,0.0
fisher,5,1,6,0.007281268349970636,11,3.4594316186372978
approached,1,1,2,0.0075161479741632405,3,1.5849625007211563
hail,1,1,0,-0.007751027598355844,1,0.0
wonderful,1,1,16,0.11438637698179682,17,4.08746284125034
couples,0,1,1,0.007574867880211391,1,0.0
candy,6,2,6,-0.00041103934233705647,12,3.5849625007211565
heat,2,1,3,0.0074574280681150885,5,2.321928094887362
funny,59,1,88,0.1645331767469172,147,7.199672344836364
hitting,3,1,3,-0.0002348796241926042,6,2.584962500721156
reno,4,1,3,-0.007927187316500297,7,2.807354922057604
decided,2,1,1,-0.007809747504403995,3,1.5849625007211563
brand,1,1,3,0.015149735760422781,4,2.0
fathers,0,1,4,0.03047563123899002,4,2.0
troopers,1,1,0,-0.007751027598355844,1,0.0
savage,1,1,2,0.0075161479741632405,3,1.5849625007211563
clearing,0,1,1,0.007574867880211391,1,0.0
ray,1,1,2,0.0075161479741632405,3,1.5849625007211563
mel,0,1,4,0.03047563123899002,4,2.0
valley,1,1,0,-0.007751027598355844,1,0.0
sons,0,1,4,0.03047563123899002,4,2.0
nobility,0,1,1,0.007574867880211391,1,0.0
tribute,3,1,3,-0.0002348796241926042,6,2.584962500721156
surrounded,0,1,1,0.007574867880211391,1,0.0
loyalty,2,1,1,-0.007809747504403995,3,1.5849625007211563
colonel,0,1,1,0.007574867880211391,1,0.0
valor,0,1,1,0.007574867880211391,1,0.0
willing,3,1,4,0.00739870816206694,7,2.807354922057604
petty,1,1,0,-0.007751027598355844,1,0.0
heist,1,1,1,-0.0001174398120963021,2,1.0
stuck,7,1,2,-0.03863769817968292,9,3.1699250014423126
bungling,1,1,0,-0.007751027598355844,1,0.0
nearly,24,1,7,-0.131238990017616,31,4.954196310386876
foster,1,2,6,0.03805049911920141,7,2.807354922057604
decade,1,1,4,0.022783323546682326,5,2.321928094887362
favourite,0,1,1,0.007574867880211391,1,0.0
loved,1,1,3,0.015149735760422781,4,2.0
gift,1,2,0,-0.007751027598355844,1,0.0
unusual,2,1,4,0.015091015854374633,6,2.584962500721156
satisfying,4,1,15,0.0836758661186142,19,4.247927513443585
california,1,1,1,-0.0001174398120963021,2,1.0
oleander,2,1,4,0.015091015854374633,6,2.584962500721156
wwii,1,1,1,-0.0001174398120963021,2,1.0
anderson,1,1,9,0.06095126247798004,10,3.3219280948873626
fault,2,1,0,-0.015443335290663537,2,1.0
charles,0,1,2,0.015208455666470933,2,1.0
respect,0,1,8,0.06100998238402819,8,3.0
whole,21,1,15,-0.04709336465061657,36,5.169925001442312
blockbuster,0,1,4,0.03047563123899002,4,2.0
standard,8,1,9,0.0071051086318261875,17,4.08746284125034
vin,0,2,4,0.03047563123899002,4,2.0
ring,3,1,3,-0.0002348796241926042,6,2.584962500721156
thrill,2,1,9,0.053258954785672344,11,3.4594316186372978
thrilled,1,1,0,-0.007751027598355844,1,0.0
your,75,1,86,0.05695830886670583,161,7.330916878114618
scope,0,1,2,0.015208455666470933,2,1.0
lot,30,1,37,0.051614797416324104,67,6.066089190457772
natural,2,1,5,0.022724603640634174,7,2.807354922057604
nihilistic,1,1,0,-0.007751027598355844,1,0.0
cohen,0,1,1,0.007574867880211391,1,0.0
clever,11,1,16,0.037463300058719895,27,4.754887502163469
lousy,5,1,0,-0.038520258367586616,5,2.321928094887362
succeed,0,1,4,0.03047563123899002,4,2.0
junkie,1,1,1,-0.0001174398120963021,2,1.0
deemed,0,1,1,0.007574867880211391,1,0.0
avoid,5,1,2,-0.02325308279506753,7,2.807354922057604
xxx,8,4,8,-0.0005284791544333534,16,4.0
diesel,2,3,6,0.030358191426893714,8,3.0
ruthless,1,1,0,-0.007751027598355844,1,0.0
disappointing,5,0,4,-0.007985907222548445,9,3.1699250014423126
silly,30,0,13,-0.1315913094539049,43,5.426264754702098
subtlety,2,0,0,-0.015443335290663537,2,1.0
coda,1,0,0,-0.007751027598355844,1,0.0
gaghan,4,0,1,-0.023194362889019382,5,2.321928094887362
creepy,8,0,9,0.0071051086318261875,17,4.08746284125034
lit,4,0,0,-0.030827950675278923,4,2.0
captures,1,0,5,0.030416911332941866,6,2.584962500721156
dorm,1,0,0,-0.007751027598355844,1,0.0
rooms,1,0,0,-0.007751027598355844,1,0.0
parting,1,0,0,-0.007751027598355844,1,0.0
misfires,1,0,0,-0.007751027598355844,1,0.0
dull,21,0,5,-0.123429242513212,26,4.700439718141093
peg,0,0,1,0.007574867880211391,1,0.0
often,25,0,40,0.11297709923664123,65,6.022367813028454
plain,14,0,2,-0.09248385202583677,16,4.0
paced,6,0,6,-0.00041103934233705647,12,3.5849625007211565
meandering,7,0,1,-0.04627128596594246,8,3.0
glacially,1,0,0,-0.007751027598355844,1,0.0
hollywood,38,0,36,-0.01755725190839691,74,6.209453365628951
angst,6,0,2,-0.030945390487375223,8,3.0
substandard,1,0,0,-0.007751027598355844,1,0.0
mill,6,0,2,-0.030945390487375223,8,3.0
profound,3,0,3,-0.0002348796241926042,6,2.584962500721156
ridden,5,0,0,-0.038520258367586616,5,2.321928094887362
picture,25,0,49,0.1816793893129771,74,6.209453365628951
saw,10,0,5,-0.03881385789782737,15,3.9068905956085187
sats,1,0,0,-0.007751027598355844,1,0.0
checking,1,0,1,-0.0001174398120963021,2,1.0
my,30,0,31,0.005813270698766859,61,5.930737337562887
fairly,4,0,12,0.06077510275983558,16,4.0
predictable,29,0,17,-0.09336465061655902,46,5.523561956057013
disjointed,5,0,1,-0.030886670581327075,6,2.584962500721156
derive,1,0,0,-0.007751027598355844,1,0.0
screenplay,24,0,6,-0.13887257780387552,30,4.906890595608519
actors,28,0,23,-0.03987081620669408,51,5.672425341971496
mediocre,14,0,1,-0.10011743981209631,15,3.9068905956085187
call,9,0,9,-0.0005871990604815053,18,4.169925001442312
stephen,2,0,2,-0.00017615971814445228,4,2.0
preamble,1,0,0,-0.007751027598355844,1,0.0
bigger,3,0,5,0.015032295948326481,8,3.0
slow,16,0,5,-0.08496770405167353,21,4.392317422778761
materializes,1,0,0,-0.007751027598355844,1,0.0
acted,7,0,16,0.06823253082795067,23,4.523561956057013
inducing,4,0,2,-0.015560775102759838,6,2.584962500721156
promise,6,0,6,-0.00041103934233705647,12,3.5849625007211565
delivery,5,0,3,-0.01561949500880799,8,3.0
premise,22,0,4,-0.13875513799177921,26,4.700439718141093
abandon,6,0,0,-0.04621256605989431,6,2.584962500721156
mess,19,0,1,-0.13857897827363477,20,4.321928094887363
puppy,1,0,0,-0.007751027598355844,1,0.0
tricks,3,0,0,-0.02313564298297123,3,1.5849625007211563
neck,2,0,1,-0.007809747504403995,3,1.5849625007211563
perform,1,0,0,-0.007751027598355844,1,0.0
certainly,14,0,17,0.02201996476805637,31,4.954196310386876
resume,1,0,1,-0.0001174398120963021,2,1.0
intense,0,0,10,0.07627715795654727,10,3.3219280948873626
otherwise,11,0,14,0.022196124486200813,25,4.643856189774724
hurt,0,0,3,0.022842043452730474,3,1.5849625007211563
ye,2,0,0,-0.015443335290663537,2,1.0
dante,3,0,0,-0.02313564298297123,3,1.5849625007211563
definitely,7,0,10,0.02243100411039342,17,4.08746284125034
words,6,0,7,0.007222548443922484,13,3.700439718141092
here,44,0,33,-0.08661186142102173,77,6.266786540694902
gloomy,2,0,1,-0.007809747504403995,3,1.5849625007211563
obvious,23,0,3,-0.15408103347034646,26,4.700439718141093
muddy,3,0,0,-0.02313564298297123,3,1.5849625007211563
rife,2,0,0,-0.015443335290663537,2,1.0
miscalculations,1,0,0,-0.007751027598355844,1,0.0
scarcely,2,0,0,-0.015443335290663537,2,1.0
underachiever,1,0,0,-0.007751027598355844,1,0.0
sweet,15,0,27,0.09066353493834409,42,5.392317422778761
lady,2,0,0,-0.015443335290663537,2,1.0
presence,4,0,2,-0.015560775102759838,6,2.584962500721156
damaged,0,0,1,0.007574867880211391,1,0.0
study,8,0,13,0.03763945977686435,21,4.392317422778761
revealing,0,0,4,0.03047563123899002,4,2.0
inevitably,0,0,1,0.007574867880211391,1,0.0
goods,0,0,6,0.0457428068115091,6,2.584962500721156
orbits,0,0,2,0.015208455666470933,2,1.0
cheap,13,0,5,-0.061890780974750446,18,4.169925001442312
traffic,2,0,1,-0.007809747504403995,3,1.5849625007211563
scribe,2,0,0,-0.015443335290663537,2,1.0
directorial,5,0,4,-0.007985907222548445,9,3.1699250014423126
debut,11,0,11,-0.0007046388725778091,22,4.459431618637297
pieces,6,0,6,-0.00041103934233705647,12,3.5849625007211565
mapquest,1,0,0,-0.007751027598355844,1,0.0
emailed,1,0,0,-0.007751027598355844,1,0.0
driving,3,0,1,-0.015502055196711688,4,2.0
unwieldy,2,0,0,-0.015443335290663537,2,1.0
helpfully,1,0,0,-0.007751027598355844,1,0.0
title,34,0,10,-0.18526130358191426,44,5.459431618637297
read,8,0,6,-0.015795654726952442,14,3.8073549220576037
anywhere,3,0,0,-0.02313564298297123,3,1.5849625007211563
succinct,1,0,1,-0.0001174398120963021,2,1.0
challenging,2,0,6,0.030358191426893714,8,3.0
intermittently,5,0,4,-0.007985907222548445,9,3.1699250014423126
muddle,0,0,3,0.022842043452730474,3,1.5849625007211563
convoluted,1,0,2,0.0075161479741632405,3,1.5849625007211563
unflaggingly,0,0,1,0.007574867880211391,1,0.0
suspenseful,4,0,6,0.014973576042278329,10,3.3219280948873626
nonsensical,3,0,0,-0.02313564298297123,3,1.5849625007211563
sign,7,0,1,-0.04627128596594246,8,3.0
whodunit,3,0,2,-0.007868467410452145,5,2.321928094887362
instantly,3,0,1,-0.015502055196711688,4,2.0
guessing,4,0,0,-0.030827950675278923,4,2.0
confused,3,0,0,-0.02313564298297123,3,1.5849625007211563
trite,3,0,1,-0.015502055196711688,4,2.0
suspecting,1,0,0,-0.007751027598355844,1,0.0
wrap,2,0,0,-0.015443335290663537,2,1.0
recent,7,0,12,0.0376981796829125,19,4.247927513443585
incoherent,5,0,0,-0.038520258367586616,5,2.321928094887362
features,4,0,7,0.02260716382853787,11,3.4594316186372978
sloughs,1,0,0,-0.007751027598355844,1,0.0
alleged,3,0,0,-0.02313564298297123,3,1.5849625007211563
mire,1,0,0,-0.007751027598355844,1,0.0
atmospheric,0,0,3,0.022842043452730474,3,1.5849625007211563
jaw,0,0,4,0.03047563123899002,4,2.0
behavior,0,0,2,0.015208455666470933,2,1.0
chills,1,0,2,0.0075161479741632405,3,1.5849625007211563
appealing,4,0,11,0.05314151497357604,15,3.9068905956085187
droppingly,0,0,1,0.007574867880211391,1,0.0
weirdness,0,0,3,0.022842043452730474,3,1.5849625007211563
moments,27,0,30,0.02125660598943041,57,5.832890014164742
weirdly,0,0,5,0.03810921902524956,5,2.321928094887362
nevertheless,1,0,4,0.022783323546682326,5,2.321928094887362
hardly,8,0,7,-0.008162066940692901,15,3.9068905956085187
nuanced,1,0,3,0.015149735760422781,4,2.0
scares,3,0,2,-0.007868467410452145,5,2.321928094887362
breakdown,1,0,0,-0.007751027598355844,1,0.0
interesting,19,0,22,0.021726365237815598,41,5.357552004618084
concept,11,0,6,-0.03887257780387552,17,4.08746284125034
expands,1,0,0,-0.007751027598355844,1,0.0
boredom,2,0,0,-0.015443335290663537,2,1.0
horizons,1,0,0,-0.007751027598355844,1,0.0
dullness,2,0,0,-0.015443335290663537,2,1.0
pseudo,6,0,2,-0.030945390487375223,8,3.0
intentionally,3,0,0,-0.02313564298297123,3,1.5849625007211563
90,12,0,3,-0.06946564885496184,15,3.9068905956085187
minutes,48,0,24,-0.18608338226658835,72,6.169925001442312
recognize,2,0,3,0.0074574280681150885,5,2.321928094887362
fluttering,0,0,1,0.007574867880211391,1,0.0
usual,8,0,13,0.03763945977686435,21,4.392317422778761
stammering,0,0,1,0.007574867880211391,1,0.0
carries,4,0,8,0.030240751614797418,12,3.5849625007211565
impeccable,1,0,2,0.0075161479741632405,3,1.5849625007211563
intellect,0,0,1,0.007574867880211391,1,0.0
charm,10,0,22,0.09095713446858483,32,5.0
raffish,0,0,1,0.007574867880211391,1,0.0
winning,0,0,13,0.09917792131532589,13,3.700439718141092
bumbling,0,0,2,0.015208455666470933,2,1.0
vehicle,5,0,6,0.007281268349970636,11,3.4594316186372978
narrative,7,0,11,0.030064591896652962,18,4.169925001442312
sadness,0,0,4,0.03047563123899002,4,2.0
edges,0,0,5,0.03810921902524956,5,2.321928094887362
vein,1,0,3,0.015149735760422781,4,2.0
drag,11,0,3,-0.06177334116265415,14,3.8073549220576037
probably,15,0,20,0.03722842043452729,35,5.129283016944966
appeal,6,0,9,0.022489724016441573,15,3.9068905956085187
factor,2,0,1,-0.007809747504403995,3,1.5849625007211563
incisive,0,0,4,0.03047563123899002,4,2.0
girlfriends,0,0,1,0.007574867880211391,1,0.0
refreshingly,0,0,3,0.022842043452730474,3,1.5849625007211563
funeral,1,0,2,0.0075161479741632405,3,1.5849625007211563
hill,8,0,6,-0.015795654726952442,14,3.8073549220576037
bridget,0,0,2,0.015208455666470933,2,1.0
liked,5,0,6,0.007281268349970636,11,3.4594316186372978
notting,2,0,2,-0.00017615971814445228,4,2.0
weddings,0,0,3,0.022842043452730474,3,1.5849625007211563
won,16,0,23,0.05243687610099823,39,5.285402218862249
fidelity,0,0,2,0.015208455666470933,2,1.0
bathos,0,0,2,0.015208455666470933,2,1.0
acidity,0,0,1,0.007574867880211391,1,0.0
succumbing,0,0,1,0.007574867880211391,1,0.0
thoroughly,5,0,9,0.030182031708749266,14,3.8073549220576037
deprecating,2,0,3,0.0074574280681150885,5,2.321928094887362
stammers,0,0,1,0.007574867880211391,1,0.0
floppy,0,0,1,0.007574867880211391,1,0.0
assured,1,0,3,0.015149735760422781,4,2.0
hoult,0,0,1,0.007574867880211391,1,0.0
flawed,1,0,12,0.08385202583675866,13,3.700439718141092
surprisingly,8,0,23,0.11397533763945977,31,4.954196310386876
engaging,9,0,15,0.04521432765707574,24,4.584962500721157
touching,0,0,12,0.09154433352906635,12,3.5849625007211565
pleasurable,0,0,3,0.022842043452730474,3,1.5849625007211563
featherweight,0,0,3,0.022842043452730474,3,1.5849625007211563
effortless,0,0,1,0.007574867880211391,1,0.0
4,1,0,2,0.0075161479741632405,3,1.5849625007211563
units,0,0,2,0.015208455666470933,2,1.0
perfection,1,0,2,0.0075161479741632405,3,1.5849625007211563
cadness,0,0,1,0.007574867880211391,1,0.0
display,1,0,2,0.0075161479741632405,3,1.5849625007211563
forte,0,0,1,0.007574867880211391,1,0.0
hearted,4,0,5,0.007339988256018788,9,3.1699250014423126
cary,1,0,1,-0.0001174398120963021,2,1.0
latches,0,0,1,0.007574867880211391,1,0.0
vividly,0,0,7,0.05337639459776864,7,2.807354922057604
affectionate,0,0,2,0.015208455666470933,2,1.0
recalls,0,0,1,0.007574867880211391,1,0.0
houseboat,0,0,1,0.007574867880211391,1,0.0
reluctant,1,0,2,0.0075161479741632405,3,1.5849625007211563
depiction,1,0,6,0.03805049911920141,7,2.807354922057604
sides,1,0,5,0.030416911332941866,6,2.584962500721156
tone,6,0,14,0.06065766294773928,20,4.321928094887363
hasn,7,0,4,-0.02337052260716383,11,3.4594316186372978
credit,3,0,7,0.030299471520845563,10,3.3219280948873626
buoyant,0,0,3,0.022842043452730474,3,1.5849625007211563
2002,10,0,6,-0.031180270111567827,16,4.0
mature,1,0,4,0.022783323546682326,5,2.321928094887362
hollowness,0,0,1,0.007574867880211391,1,0.0
amusing,15,0,17,0.014327657075748679,32,5.0
pencil,1,0,1,-0.0001174398120963021,2,1.0
miraculously,0,0,1,0.007574867880211391,1,0.0
anyway,0,0,3,0.022842043452730474,3,1.5849625007211563
weak,10,0,4,-0.04644744568408691,14,3.8073549220576037
entertain,1,0,7,0.04568408690546095,8,3.0
manipulative,8,0,2,-0.04633000587199061,10,3.3219280948873626
thin,10,0,4,-0.04644744568408691,14,3.8073549220576037
allowing,0,0,1,0.007574867880211391,1,0.0
persona,3,0,2,-0.007868467410452145,5,2.321928094887362
tied,1,0,2,0.0075161479741632405,3,1.5849625007211563
insightful,2,0,3,0.0074574280681150885,5,2.321928094887362
enlightening,0,0,2,0.015208455666470933,2,1.0
rewarding,0,0,3,0.022842043452730474,3,1.5849625007211563
hugely,0,0,6,0.0457428068115091,6,2.584962500721156
films,35,0,56,0.14292425132119785,91,6.507794640198696
excellent,4,0,14,0.07604227833235466,18,4.169925001442312
packed,3,0,9,0.04556664709336465,12,3.5849625007211565
beautifully,4,0,11,0.05314151497357604,15,3.9068905956085187
proceedings,3,0,2,-0.007868467410452145,5,2.321928094887362
freshness,1,0,4,0.022783323546682326,5,2.321928094887362
enjoyable,8,0,30,0.16741045214327657,38,5.247927513443585
100,5,0,3,-0.01561949500880799,8,3.0
injects,0,0,1,0.007574867880211391,1,0.0
provide,4,0,3,-0.007927187316500297,7,2.807354922057604
acidic,0,0,1,0.007574867880211391,1,0.0
brit,1,0,2,0.0075161479741632405,3,1.5849625007211563
repeatedly,2,0,1,-0.007809747504403995,3,1.5849625007211563
lovely,4,0,7,0.02260716382853787,11,3.4594316186372978
sticks,0,0,3,0.022842043452730474,3,1.5849625007211563
confessional,1,0,1,-0.0001174398120963021,2,1.0
version,18,0,14,-0.031650029359953036,32,5.0
soggy,7,0,0,-0.053904873752202,7,2.807354922057604
timid,2,0,1,-0.007809747504403995,3,1.5849625007211563
infantile,3,0,1,-0.015502055196711688,4,2.0
infantilized,0,0,1,0.007574867880211391,1,0.0
flick,22,0,25,0.021550205519671156,47,5.554588851677638
entirely,6,0,10,0.030123311802701114,16,4.0
whip,0,0,1,0.007574867880211391,1,0.0
wonderfully,0,0,7,0.05337639459776864,7,2.807354922057604
dyspeptic,0,0,1,0.007574867880211391,1,0.0
interpret,0,0,1,0.007574867880211391,1,0.0
optimistic,0,0,2,0.015208455666470933,2,1.0
darker,1,0,3,0.015149735760422781,4,2.0
payne,1,0,6,0.03805049911920141,7,2.807354922057604
hopeful,0,0,2,0.015208455666470933,2,1.0
bore,5,0,0,-0.038520258367586616,5,2.321928094887362
bravado,2,0,1,-0.007809747504403995,3,1.5849625007211563
kathy,2,0,0,-0.015443335290663537,2,1.0
bates,1,0,1,-0.0001174398120963021,2,1.0
rendered,1,0,2,0.0075161479741632405,3,1.5849625007211563
laughter,3,0,6,0.022665883734586022,9,3.1699250014423126
hurts,0,0,1,0.007574867880211391,1,0.0
rough,3,0,2,-0.007868467410452145,5,2.321928094887362
relaxed,0,0,2,0.015208455666470933,2,1.0
inconsistent,3,0,1,-0.015502055196711688,4,2.0
quiet,1,0,11,0.07621843805049912,12,3.5849625007211565
unforgivingly,0,0,1,0.007574867880211391,1,0.0
pace,2,0,12,0.07615971814445097,14,3.8073549220576037
beauty,0,0,9,0.06864357017028773,9,3.1699250014423126
details,2,0,5,0.022724603640634174,7,2.807354922057604
ode,0,0,2,0.015208455666470933,2,1.0
everyman,1,0,1,-0.0001174398120963021,2,1.0
alexander,0,0,2,0.015208455666470933,2,1.0
existed,1,0,1,-0.0001174398120963021,2,1.0
tonto,0,0,1,0.007574867880211391,1,0.0
sharpest,0,0,1,0.007574867880211391,1,0.0
truest,0,0,1,0.007574867880211391,1,0.0
filmmaking,6,0,14,0.06065766294773928,20,4.321928094887363
clearly,6,0,3,-0.023311802701115682,9,3.1699250014423126
americanathe,0,0,1,0.007574867880211391,1,0.0
hooked,0,0,1,0.007574867880211391,1,0.0
dialogue,30,0,17,-0.10105695830886671,47,5.554588851677638
pokes,1,0,3,0.015149735760422781,4,2.0
redeeming,2,0,1,-0.007809747504403995,3,1.5849625007211563
virtues,2,0,2,-0.00017615971814445228,4,2.0
understated,0,0,2,0.015208455666470933,2,1.0
neglected,0,0,3,0.022842043452730474,3,1.5849625007211563
fijos,0,0,1,0.007574867880211391,1,0.0
sin,3,0,3,-0.0002348796241926042,6,2.584962500721156
revelaciones,0,0,1,0.007574867880211391,1,0.0
observación,0,0,1,0.007574867880211391,1,0.0
ni,0,0,3,0.022842043452730474,3,1.5849625007211563
una,5,0,5,-0.00035231943628890455,10,3.3219280948873626
un,4,0,5,0.007339988256018788,9,3.1699250014423126
personajes,0,0,2,0.015208455666470933,2,1.0
estridencias,0,0,1,0.007574867880211391,1,0.0
pausado,0,0,1,0.007574867880211391,1,0.0
tomas,0,0,1,0.007574867880211391,1,0.0
planos,0,0,1,0.007574867880211391,1,0.0
y,5,0,17,0.0912507339988256,22,4.459431618637297
largas,0,0,1,0.007574867880211391,1,0.0
sutil,0,0,1,0.007574867880211391,1,0.0
sus,0,0,2,0.015208455666470933,2,1.0
grandes,0,0,1,0.007574867880211391,1,0.0
ritmo,0,0,1,0.007574867880211391,1,0.0
incapable,1,0,1,-0.0001174398120963021,2,1.0
consummate,1,0,0,-0.007751027598355844,1,0.0
watchable,5,0,10,0.037815619495008806,15,3.9068905956085187
actor,21,0,14,-0.054726952436876114,35,5.129283016944966
bravura,1,0,2,0.0075161479741632405,3,1.5849625007211563
heartfelt,1,0,9,0.06095126247798004,10,3.3219280948873626
lear,0,0,1,0.007574867880211391,1,0.0
king,1,0,5,0.030416911332941866,6,2.584962500721156
goofy,8,0,4,-0.031062830299471524,12,3.5849625007211565
actuación,0,0,2,0.015208455666470933,2,1.0
ternura,0,0,1,0.007574867880211391,1,0.0
mueve,0,0,1,0.007574867880211391,1,0.0
verdaderamente,0,0,1,0.007574867880211391,1,0.0
compasión,0,0,1,0.007574867880211391,1,0.0
entrañable,0,0,1,0.007574867880211391,1,0.0
cautionary,3,0,3,-0.0002348796241926042,6,2.584962500721156
viewed,0,0,3,0.022842043452730474,3,1.5849625007211563
trademark,3,0,2,-0.007868467410452145,5,2.321928094887362
subdues,0,0,1,0.007574867880211391,1,0.0
mannerisms,1,0,1,-0.0001174398120963021,2,1.0
exuberance,0,0,2,0.015208455666470933,2,1.0
flamboyant,1,0,2,0.0075161479741632405,3,1.5849625007211563
belongs,3,0,3,-0.0002348796241926042,6,2.584962500721156
deliberate,0,0,2,0.015208455666470933,2,1.0
gait,0,0,1,0.007574867880211391,1,0.0
chooses,0,0,2,0.015208455666470933,2,1.0
carefully,1,0,5,0.030416911332941866,6,2.584962500721156
provoking,4,0,10,0.0455079271873165,14,3.8073549220576037
isolation,0,0,1,0.007574867880211391,1,0.0
frustrating,3,0,1,-0.015502055196711688,4,2.0
patchwork,2,0,0,-0.015443335290663537,2,1.0
source,4,0,6,0.014973576042278329,10,3.3219280948873626
begley,1,0,0,-0.007751027598355844,1,0.0
uneasy,2,0,1,-0.007809747504403995,3,1.5849625007211563
fearless,0,0,2,0.015208455666470933,2,1.0
brilliantly,3,0,4,0.00739870816206694,7,2.807354922057604
taylor,3,0,2,-0.007868467410452145,5,2.321928094887362
employ,1,0,1,-0.0001174398120963021,2,1.0
election,1,0,1,-0.0001174398120963021,2,1.0
laughing,5,0,2,-0.02325308279506753,7,2.807354922057604
softened,0,0,1,0.007574867880211391,1,0.0
delivered,3,0,5,0.015032295948326481,8,3.0
grace,1,0,6,0.03805049911920141,7,2.807354922057604
masterpiece,1,0,11,0.07621843805049912,12,3.5849625007211565
sixty,0,0,1,0.007574867880211391,1,0.0
afar,0,0,1,0.007574867880211391,1,0.0
awareness,0,0,4,0.03047563123899002,4,2.0
toward,5,0,3,-0.01561949500880799,8,3.0
deadpan,0,0,1,0.007574867880211391,1,0.0
profoundly,0,0,2,0.015208455666470933,2,1.0
featuring,4,0,5,0.007339988256018788,9,3.1699250014423126
constructs,0,0,2,0.015208455666470933,2,1.0
endearing,3,0,5,0.015032295948326481,8,3.0
middle,10,0,8,-0.01591309453904874,18,4.169925001442312
pathetic,4,0,2,-0.015560775102759838,6,2.584962500721156
odyssey,0,0,3,0.022842043452730474,3,1.5849625007211563
went,7,0,2,-0.03863769817968292,9,3.1699250014423126
whiplash,0,0,1,0.007574867880211391,1,0.0
glad,1,0,2,0.0075161479741632405,3,1.5849625007211563
recommend,7,0,6,-0.00810334703464475,13,3.700439718141092
rarely,2,0,7,0.037991779213153255,9,3.1699250014423126
brutally,2,0,2,-0.00017615971814445228,4,2.0
numbness,0,0,1,0.007574867880211391,1,0.0
satire,11,0,12,0.006928948913681732,23,4.523561956057013
12th,0,0,1,0.007574867880211391,1,0.0
nomination,0,0,3,0.022842043452730474,3,1.5849625007211563
65,1,0,1,-0.0001174398120963021,2,1.0
artfully,1,0,3,0.015149735760422781,4,2.0
choosing,0,0,1,0.007574867880211391,1,0.0
actuary,0,0,1,0.007574867880211391,1,0.0
restrained,1,0,2,0.0075161479741632405,3,1.5849625007211563
proving,0,0,2,0.015208455666470933,2,1.0
precision,1,0,2,0.0075161479741632405,3,1.5849625007211563
undoubtedly,1,0,2,0.0075161479741632405,3,1.5849625007211563
pulse,3,0,3,-0.0002348796241926042,6,2.584962500721156
finest,2,0,6,0.030358191426893714,8,3.0
check,2,0,4,0.015091015854374633,6,2.584962500721156
touched,0,0,2,0.015208455666470933,2,1.0
someplace,0,0,1,0.007574867880211391,1,0.0
absorption,0,0,1,0.007574867880211391,1,0.0
insistently,0,0,2,0.015208455666470933,2,1.0
otherness,0,0,1,0.007574867880211391,1,0.0
perfectly,6,0,13,0.053024075161479736,19,4.247927513443585
demanding,2,0,1,-0.007809747504403995,3,1.5849625007211563
consuming,1,0,1,-0.0001174398120963021,2,1.0
pitched,0,0,2,0.015208455666470933,2,1.0
expressing,0,0,1,0.007574867880211391,1,0.0
legend,0,0,2,0.015208455666470933,2,1.0
craft,0,0,5,0.03810921902524956,5,2.321928094887362
boomers,0,0,2,0.015208455666470933,2,1.0
uplifting,1,0,5,0.030416911332941866,6,2.584962500721156
impressive,5,0,11,0.04544920728126835,16,4.0
succeeds,1,0,10,0.06858485026423958,11,3.4594316186372978
aims,1,0,7,0.04568408690546095,8,3.0
extent,2,0,2,-0.00017615971814445228,4,2.0
brush,0,0,1,0.007574867880211391,1,0.0
canvas,0,0,3,0.022842043452730474,3,1.5849625007211563
proves,7,0,12,0.0376981796829125,19,4.247927513443585
sean,0,0,1,0.007574867880211391,1,0.0
penn,0,0,1,0.007574867880211391,1,0.0
apology,0,0,1,0.007574867880211391,1,0.0
owe,2,0,1,-0.007809747504403995,3,1.5849625007211563
nicolas,2,0,1,-0.007809747504403995,3,1.5849625007211563
befuddlement,0,0,1,0.007574867880211391,1,0.0
presents,5,0,7,0.014914856136230177,12,3.5849625007211565
scathing,0,0,3,0.022842043452730474,3,1.5849625007211563
indictment,0,0,2,0.015208455666470933,2,1.0
taps,0,0,2,0.015208455666470933,2,1.0
drives,0,0,3,0.022842043452730474,3,1.5849625007211563
genuine,7,0,10,0.02243100411039342,17,4.08746284125034
nervy,1,0,1,-0.0001174398120963021,2,1.0
reasons,2,0,2,-0.00017615971814445228,4,2.0
ponders,0,0,1,0.007574867880211391,1,0.0
seamlessly,0,0,2,0.015208455666470933,2,1.0
jonze,0,0,3,0.022842043452730474,3,1.5849625007211563
outrageously,1,0,1,-0.0001174398120963021,2,1.0
original,32,0,33,0.005695830886670583,65,6.022367813028454
offbeat,1,0,5,0.030416911332941866,6,2.584962500721156
manage,3,0,7,0.030299471520845563,10,3.3219280948873626
marks,2,0,5,0.022724603640634174,7,2.807354922057604
watch,29,0,20,-0.07046388725778041,49,5.614709844115208
themes,4,0,11,0.05314151497357604,15,3.9068905956085187
constructed,4,0,5,0.007339988256018788,9,3.1699250014423126
nails,0,0,3,0.022842043452730474,3,1.5849625007211563
intricately,0,0,1,0.007574867880211391,1,0.0
excitement,5,0,8,0.022548443922489725,13,3.700439718141092
flash,4,0,2,-0.015560775102759838,6,2.584962500721156
outstanding,1,0,4,0.022783323546682326,5,2.321928094887362
niche,0,0,1,0.007574867880211391,1,0.0
navel,1,0,2,0.0075161479741632405,3,1.5849625007211563
gazing,1,0,2,0.0075161479741632405,3,1.5849625007211563
insecurity,0,0,3,0.022842043452730474,3,1.5849625007211563
infinite,0,0,1,0.007574867880211391,1,0.0
originality,6,0,12,0.045390487375220195,18,4.169925001442312
carved,1,0,1,-0.0001174398120963021,2,1.0
fluke,0,0,1,0.007574867880211391,1,0.0
malkovich,0,0,2,0.015208455666470933,2,1.0
hysterically,0,0,1,0.007574867880211391,1,0.0
cruelly,1,0,1,-0.0001174398120963021,2,1.0
observant,0,0,3,0.022842043452730474,3,1.5849625007211563
corner,1,0,3,0.015149735760422781,4,2.0
scores,4,0,4,-0.00029359953024075264,8,3.0
writes,0,0,1,0.007574867880211391,1,0.0
hour,17,0,10,-0.054492072812683506,27,4.754887502163469
loopy,2,0,1,-0.007809747504403995,3,1.5849625007211563
allá,0,0,1,0.007574867880211391,1,0.0
diría,0,0,1,0.007574867880211391,1,0.0
película,0,0,3,0.022842043452730474,3,1.5849625007211563
lógica,0,0,1,0.007574867880211391,1,0.0
más,1,0,3,0.015149735760422781,4,2.0
se,1,0,5,0.030416911332941866,6,2.584962500721156
toda,0,0,1,0.007574867880211391,1,0.0
bankruptcy,0,0,1,0.007574867880211391,1,0.0
weird,6,0,4,-0.015678214914856138,10,3.3219280948873626
meditation,0,0,5,0.03810921902524956,5,2.321928094887362
brain,5,0,8,0.022548443922489725,13,3.700439718141092
integrity,0,0,7,0.05337639459776864,7,2.807354922057604
twister,0,0,1,0.007574867880211391,1,0.0
almost,31,0,30,-0.00951262477980036,61,5.930737337562887
watching,25,0,22,-0.02442748091603056,47,5.554588851677638
writing,12,0,7,-0.03893129770992367,19,4.247927513443585
hypnotizing,0,0,1,0.007574867880211391,1,0.0
overall,8,0,11,0.02237228420434527,19,4.247927513443585
gonads,0,0,1,0.007574867880211391,1,0.0
intricate,2,0,3,0.0074574280681150885,5,2.321928094887362
subtracts,0,0,1,0.007574867880211391,1,0.0
excitingly,0,0,1,0.007574867880211391,1,0.0
surrealism,0,0,1,0.007574867880211391,1,0.0
precisamente,0,0,1,0.007574867880211391,1,0.0
que,14,0,13,-0.008514386376981806,27,4.754887502163469
originalidad,0,0,1,0.007574867880211391,1,0.0
pena,2,0,2,-0.00017615971814445228,4,2.0
ladrón,0,0,1,0.007574867880211391,1,0.0
el,2,0,5,0.022724603640634174,7,2.807354922057604
por,2,0,2,-0.00017615971814445228,4,2.0
orquídeas,0,0,1,0.007574867880211391,1,0.0
esos,0,0,1,0.007574867880211391,1,0.0
e,4,0,7,0.02260716382853787,11,3.4594316186372978
retadora,0,0,1,0.007574867880211391,1,0.0
uno,0,0,2,0.015208455666470933,2,1.0
compleja,0,0,1,0.007574867880211391,1,0.0
ver,0,0,2,0.015208455666470933,2,1.0
su,0,0,2,0.015208455666470933,2,1.0
vale,1,0,1,-0.0001174398120963021,2,1.0
es,6,0,8,0.014856136230182032,14,3.8073549220576037
filmes,0,0,1,0.007574867880211391,1,0.0
intelectualmente,0,0,1,0.007574867880211391,1,0.0
durable,2,0,2,-0.00017615971814445228,4,2.0
species,0,0,1,0.007574867880211391,1,0.0
brash,0,0,2,0.015208455666470933,2,1.0
writers,3,0,3,-0.0002348796241926042,6,2.584962500721156
malleable,0,0,1,0.007574867880211391,1,0.0
donald,0,0,1,0.007574867880211391,1,0.0
biting,3,0,4,0.00739870816206694,7,2.807354922057604
spike,0,0,5,0.03810921902524956,5,2.321928094887362
witty,2,0,12,0.07615971814445097,14,3.8073549220576037
screenwriting,5,0,2,-0.02325308279506753,7,2.807354922057604
loneliness,0,0,3,0.022842043452730474,3,1.5849625007211563
slovenly,0,0,1,0.007574867880211391,1,0.0
ethics,1,0,1,-0.0001174398120963021,2,1.0
compelling,9,0,29,0.15208455666470932,38,5.247927513443585
scrutinize,0,0,1,0.007574867880211391,1,0.0
intelligent,11,0,15,0.029829712272460354,26,4.700439718141093
cohesive,0,0,1,0.007574867880211391,1,0.0
achievements,0,0,1,0.007574867880211391,1,0.0
fuel,0,0,2,0.015208455666470933,2,1.0
appetites,0,0,1,0.007574867880211391,1,0.0
lesser,2,0,2,-0.00017615971814445228,4,2.0
crazier,0,0,1,0.007574867880211391,1,0.0
windows,0,0,1,0.007574867880211391,1,0.0
floor,1,0,3,0.015149735760422781,4,2.0
nursery,0,0,1,0.007574867880211391,1,0.0
skyscraper,0,0,2,0.015208455666470933,2,1.0
playfully,0,0,2,0.015208455666470933,2,1.0
rat,0,0,1,0.007574867880211391,1,0.0
rage,0,0,2,0.015208455666470933,2,1.0
raging,1,0,1,-0.0001174398120963021,2,1.0
storytelling,6,0,5,-0.008044627128596597,11,3.4594316186372978
sane,2,0,1,-0.007809747504403995,3,1.5849625007211563
jumble,2,0,1,-0.007809747504403995,3,1.5849625007211563
heady,0,0,2,0.015208455666470933,2,1.0
breathtakingly,0,0,2,0.015208455666470933,2,1.0
undertaking,0,0,1,0.007574867880211391,1,0.0
coheres,0,0,1,0.007574867880211391,1,0.0
unquestionably,0,0,2,0.015208455666470933,2,1.0
genuinely,4,0,10,0.0455079271873165,14,3.8073549220576037
imagine,16,0,6,-0.07733411626541398,22,4.459431618637297
smugly,1,0,0,-0.007751027598355844,1,0.0
superior,4,0,3,-0.007927187316500297,7,2.807354922057604
shooting,7,0,1,-0.04627128596594246,8,3.0
face,8,0,11,0.02237228420434527,19,4.247927513443585
slapping,2,0,0,-0.015443335290663537,2,1.0
bewilderingly,0,0,2,0.015208455666470933,2,1.0
accurate,0,0,1,0.007574867880211391,1,0.0
surely,6,0,4,-0.015678214914856138,10,3.3219280948873626
funniest,6,0,9,0.022489724016441573,15,3.9068905956085187
gem,0,0,7,0.05337639459776864,7,2.807354922057604
sparkles,1,0,2,0.0075161479741632405,3,1.5849625007211563
extraordinary,1,0,6,0.03805049911920141,7,2.807354922057604
travails,0,0,1,0.007574867880211391,1,0.0
creating,3,0,3,-0.0002348796241926042,6,2.584962500721156
passion,4,0,12,0.06077510275983558,16,4.0
ponder,1,0,3,0.015149735760422781,4,2.0
risks,0,0,3,0.022842043452730474,3,1.5849625007211563
emptiness,1,0,1,-0.0001174398120963021,2,1.0
examine,0,0,1,0.007574867880211391,1,0.0
provides,0,0,9,0.06864357017028773,9,3.1699250014423126
defines,2,0,4,0.015091015854374633,6,2.584962500721156
trembling,0,0,1,0.007574867880211391,1,0.0
incoherence,1,0,1,-0.0001174398120963021,2,1.0
porthole,0,0,1,0.007574867880211391,1,0.0
terrier,0,0,1,0.007574867880211391,1,0.0
amorous,0,0,1,0.007574867880211391,1,0.0
fair,2,0,5,0.022724603640634174,7,2.807354922057604
hilarity,3,0,4,0.00739870816206694,7,2.807354922057604
saucy,0,0,3,0.022842043452730474,3,1.5849625007211563
consists,2,0,0,-0.015443335290663537,2,1.0
stiller,1,0,0,-0.007751027598355844,1,0.0
zoolander,1,0,0,-0.007751027598355844,1,0.0
frankly,6,0,1,-0.03857897827363477,7,2.807354922057604
joke,12,0,5,-0.054198473282442754,17,4.08746284125034
raw,1,0,5,0.030416911332941866,6,2.584962500721156
gags,25,0,6,-0.1465648854961832,31,4.954196310386876
puerile,3,0,0,-0.02313564298297123,3,1.5849625007211563
witless,5,0,1,-0.030886670581327075,6,2.584962500721156
falters,2,0,0,-0.015443335290663537,2,1.0
heavily,2,0,0,-0.015443335290663537,2,1.0
depends,2,0,2,-0.00017615971814445228,4,2.0
seriously,12,0,4,-0.061832061068702295,16,4.0
clown,3,0,0,-0.02313564298297123,3,1.5849625007211563
situations,11,0,3,-0.06177334116265415,14,3.8073549220576037
average,10,0,11,0.006987668819729884,21,4.392317422778761
supplied,1,0,0,-0.007751027598355844,1,0.0
epps,4,0,0,-0.030827950675278923,4,2.0
benefits,1,0,2,0.0075161479741632405,3,1.5849625007211563
matinee,3,0,4,0.00739870816206694,7,2.807354922057604
saturday,2,0,5,0.022724603640634174,7,2.807354922057604
downtown,0,0,1,0.007574867880211391,1,0.0
memorable,4,0,13,0.06840869054609512,17,4.08746284125034
disappoint,1,0,5,0.030416911332941866,6,2.584962500721156
benjamins,3,0,3,-0.0002348796241926042,6,2.584962500721156
air,10,0,8,-0.01591309453904874,18,4.169925001442312
feet,5,0,0,-0.038520258367586616,5,2.321928094887362
actioners,1,0,0,-0.007751027598355844,1,0.0
useless,2,0,0,-0.015443335290663537,2,1.0
mtv,4,0,1,-0.023194362889019382,5,2.321928094887362
pile,7,0,2,-0.03863769817968292,9,3.1699250014423126
schmucks,1,0,0,-0.007751027598355844,1,0.0
modest,3,0,4,0.00739870816206694,7,2.807354922057604
cable,4,0,0,-0.030827950675278923,4,2.0
amusements,1,0,0,-0.007751027598355844,1,0.0
tailor,2,0,0,-0.015443335290663537,2,1.0
evokes,1,0,1,-0.0001174398120963021,2,1.0
lackadaisical,1,0,0,-0.007751027598355844,1,0.0
bottom,7,0,3,-0.031004110393423375,10,3.3219280948873626
blaxploitation,2,0,2,-0.00017615971814445228,4,2.0
1970s,3,0,3,-0.0002348796241926042,6,2.584962500721156
tier,1,0,0,-0.007751027598355844,1,0.0
mindless,12,0,3,-0.06946564885496184,15,3.9068905956085187
plotting,7,0,1,-0.04627128596594246,8,3.0
flicks,7,0,4,-0.02337052260716383,11,3.4594316186372978
thanks,2,0,12,0.07615971814445097,14,3.8073549220576037
awful,9,0,2,-0.054022313564298305,11,3.4594316186372978
formulaic,12,0,3,-0.06946564885496184,15,3.9068905956085187
cliche,10,0,2,-0.061714621256606,12,3.5849625007211565
compensate,0,0,3,0.022842043452730474,3,1.5849625007211563
charisma,3,0,8,0.03793305930710511,11,3.4594316186372978
corniness,0,0,1,0.007574867880211391,1,0.0
clue,4,0,0,-0.030827950675278923,4,2.0
garden,1,0,1,-0.0001174398120963021,2,1.0
bray,3,0,1,-0.015502055196711688,4,2.0
exploitative,5,0,0,-0.038520258367586616,5,2.321928094887362
profane,1,0,0,-0.007751027598355844,1,0.0
offensive,9,0,0,-0.06928948913681739,9,3.1699250014423126
excels,1,0,3,0.015149735760422781,4,2.0
kevin,4,0,1,-0.023194362889019382,5,2.321928094887362
breaking,1,0,1,-0.0001174398120963021,2,1.0
checklist,2,0,2,-0.00017615971814445228,4,2.0
boats,1,0,2,0.0075161479741632405,3,1.5849625007211563
glass,6,0,8,0.014856136230182032,14,3.8073549220576037
vice,3,0,1,-0.015502055196711688,4,2.0
marking,2,0,0,-0.015443335290663537,2,1.0
patched,1,0,0,-0.007751027598355844,1,0.0
episode,4,0,2,-0.015560775102759838,6,2.584962500721156
ole,1,0,0,-0.007751027598355844,1,0.0
ineptitude,1,0,0,-0.007751027598355844,1,0.0
wholesale,1,0,0,-0.007751027598355844,1,0.0
mark,4,0,10,0.0455079271873165,14,3.8073549220576037
helmer,4,0,0,-0.030827950675278923,4,2.0
crisp,3,0,2,-0.007868467410452145,5,2.321928094887362
edgy,2,0,1,-0.007809747504403995,3,1.5849625007211563
ethically,0,0,1,0.007574867880211391,1,0.0
caper,1,0,6,0.03805049911920141,7,2.807354922057604
threadbare,2,0,1,-0.007809747504403995,3,1.5849625007211563
diversion,3,0,9,0.04556664709336465,12,3.5849625007211565
remarkably,3,0,4,0.00739870816206694,7,2.807354922057604
poorly,11,0,0,-0.08467410452143277,11,3.4594316186372978
lack,19,0,7,-0.09277745155607753,26,4.700439718141093
generic,12,0,1,-0.08473282442748092,13,3.700439718141092
accents,1,0,1,-0.0001174398120963021,2,1.0
intrigue,6,0,2,-0.030945390487375223,8,3.0
48,4,0,0,-0.030827950675278923,4,2.0
sort,13,0,9,-0.031356429829712276,22,4.459431618637297
hrs,2,0,0,-0.015443335290663537,2,1.0
genial,1,0,3,0.015149735760422781,4,2.0
brow,2,0,0,-0.015443335290663537,2,1.0
gratuitous,2,0,0,-0.015443335290663537,2,1.0
disregard,1,0,0,-0.007751027598355844,1,0.0
begets,1,0,0,-0.007751027598355844,1,0.0
groan,2,0,0,-0.015443335290663537,2,1.0
familiarity,2,0,0,-0.015443335290663537,2,1.0
retro,2,0,3,0.0074574280681150885,5,2.321928094887362
stuff,11,0,8,-0.02360540223135643,19,4.247927513443585
expensive,0,0,1,0.007574867880211391,1,0.0
celebration,1,0,1,-0.0001174398120963021,2,1.0
grabs,0,0,1,0.007574867880211391,1,0.0
shameless,3,0,3,-0.0002348796241926042,6,2.584962500721156
vulgar,3,0,1,-0.015502055196711688,4,2.0
forgettably,2,0,0,-0.015443335290663537,2,1.0
sinks,7,0,0,-0.053904873752202,7,2.807354922057604
territory,7,0,0,-0.053904873752202,7,2.807354922057604
standardized,0,0,1,0.007574867880211391,1,0.0
hedonistic,0,0,2,0.015208455666470933,2,1.0
gusto,0,0,3,0.022842043452730474,3,1.5849625007211563
clichés,7,0,2,-0.03863769817968292,9,3.1699250014423126
bang,3,0,3,-0.0002348796241926042,6,2.584962500721156
extravaganza,2,0,1,-0.007809747504403995,3,1.5849625007211563
slam,0,0,3,0.022842043452730474,3,1.5849625007211563
subject,8,0,20,0.09107457428068114,28,4.807354922057604
depressing,3,0,4,0.00739870816206694,7,2.807354922057604
achievement,2,0,5,0.022724603640634174,7,2.807354922057604
manville,0,0,1,0.007574867880211391,1,0.0
unrelenting,1,0,2,0.0075161479741632405,3,1.5849625007211563
bleakness,0,0,2,0.015208455666470933,2,1.0
spall,0,0,3,0.022842043452730474,3,1.5849625007211563
somewhere,3,0,8,0.03793305930710511,11,3.4594316186372978
disappointments,1,0,0,-0.007751027598355844,1,0.0
lazy,8,0,2,-0.04633000587199061,10,3.3219280948873626
miserable,4,0,0,-0.030827950675278923,4,2.0
smug,4,0,0,-0.030827950675278923,4,2.0
intentioned,3,0,1,-0.015502055196711688,4,2.0
pessimistic,0,0,1,0.007574867880211391,1,0.0
unflinching,0,0,4,0.03047563123899002,4,2.0
perilously,1,0,2,0.0075161479741632405,3,1.5849625007211563
ear,2,0,2,-0.00017615971814445228,4,2.0
uncanny,1,0,1,-0.0001174398120963021,2,1.0
characterization,5,0,1,-0.030886670581327075,6,2.584962500721156
culled,1,0,0,-0.007751027598355844,1,0.0
procession,2,0,1,-0.007809747504403995,3,1.5849625007211563
cello,1,0,1,-0.0001174398120963021,2,1.0
minimalist,2,0,2,-0.00017615971814445228,4,2.0
comparison,6,0,1,-0.03857897827363477,7,2.807354922057604
disappointingly,3,0,0,-0.02313564298297123,3,1.5849625007211563
lower,4,0,1,-0.023194362889019382,5,2.321928094887362
titleamounts,1,0,0,-0.007751027598355844,1,0.0
felt,7,0,4,-0.02337052260716383,11,3.4594316186372978
sobering,0,0,6,0.0457428068115091,6,2.584962500721156
correct,0,0,1,0.007574867880211391,1,0.0
marvelously,0,0,2,0.015208455666470933,2,1.0
interaction,1,0,3,0.015149735760422781,4,2.0
sheepish,0,0,1,0.007574867880211391,1,0.0
example,2,0,8,0.0456253669994128,10,3.3219280948873626
dreary,6,0,2,-0.030945390487375223,8,3.0
leigh,2,0,11,0.06852613035819143,13,3.700439718141092
crumb,0,0,1,0.007574867880211391,1,0.0
banquet,0,0,2,0.015208455666470933,2,1.0
warmth,1,0,6,0.03805049911920141,7,2.807354922057604
coldest,0,0,1,0.007574867880211391,1,0.0
stirring,3,0,5,0.015032295948326481,8,3.0
populates,0,0,1,0.007574867880211391,1,0.0
ensemble,2,0,10,0.060892542571931885,12,3.5849625007211565
uplifts,0,0,1,0.007574867880211391,1,0.0
brims,0,0,1,0.007574867880211391,1,0.0
suit,2,0,1,-0.007809747504403995,3,1.5849625007211563
redundant,4,0,1,-0.023194362889019382,5,2.321928094887362
kudos,0,0,1,0.007574867880211391,1,0.0
superbly,0,0,3,0.022842043452730474,3,1.5849625007211563
method,0,0,1,0.007574867880211391,1,0.0
contributions,0,0,1,0.007574867880211391,1,0.0
allows,3,0,6,0.022665883734586022,9,3.1699250014423126
cinema,6,0,19,0.098825601879037,25,4.643856189774724
positive,0,0,3,0.022842043452730474,3,1.5849625007211563
notch,2,0,6,0.030358191426893714,8,3.0
sit,8,0,6,-0.015795654726952442,14,3.8073549220576037
wrench,0,0,1,0.007574867880211391,1,0.0
refreshing,1,0,12,0.08385202583675866,13,3.700439718141092
delivering,1,0,5,0.030416911332941866,6,2.584962500721156
slap,5,0,2,-0.02325308279506753,7,2.807354922057604
lays,1,0,0,-0.007751027598355844,1,0.0
downer,3,0,1,-0.015502055196711688,4,2.0
thick,2,0,3,0.0074574280681150885,5,2.321928094887362
suicide,1,0,0,-0.007751027598355844,1,0.0
tiny,1,0,2,0.0075161479741632405,3,1.5849625007211563
kindness,0,0,1,0.007574867880211391,1,0.0
conveying,1,0,2,0.0075161479741632405,3,1.5849625007211563
survivable,0,0,1,0.007574867880211391,1,0.0
improvised,0,0,1,0.007574867880211391,1,0.0
wrenching,0,0,3,0.022842043452730474,3,1.5849625007211563
locations,2,0,3,0.0074574280681150885,5,2.321928094887362
unmistakable,0,0,1,0.007574867880211391,1,0.0
bearing,1,0,1,-0.0001174398120963021,2,1.0
language,2,0,3,0.0074574280681150885,5,2.321928094887362
authority,1,0,3,0.015149735760422781,4,2.0
hint,0,0,4,0.03047563123899002,4,2.0
elegantly,2,0,1,-0.007809747504403995,3,1.5849625007211563
fascinating,4,0,22,0.137110980622431,26,4.700439718141093
artifice,2,0,2,-0.00017615971814445228,4,2.0
balanced,0,0,3,0.022842043452730474,3,1.5849625007211563
member,1,0,2,0.0075161479741632405,3,1.5849625007211563
reflect,0,0,1,0.007574867880211391,1,0.0
indeed,7,0,5,-0.01573693482090429,12,3.5849625007211565
masterful,0,0,5,0.03810921902524956,5,2.321928094887362
darkness,1,0,1,-0.0001174398120963021,2,1.0
hews,0,0,1,0.007574867880211391,1,0.0
triumph,2,0,8,0.0456253669994128,10,3.3219280948873626
effortlessly,0,0,1,0.007574867880211391,1,0.0
rumination,1,0,1,-0.0001174398120963021,2,1.0
succumb,1,0,1,-0.0001174398120963021,2,1.0
melancholic,0,0,1,0.007574867880211391,1,0.0
rhythms,0,0,3,0.022842043452730474,3,1.5849625007211563
humanistic,0,0,2,0.015208455666470933,2,1.0
ground,6,0,2,-0.030945390487375223,8,3.0
grind,0,0,2,0.015208455666470933,2,1.0
portrayals,1,0,1,-0.0001174398120963021,2,1.0
showiness,1,0,0,-0.007751027598355844,1,0.0
mined,2,0,0,-0.015443335290663537,2,1.0
tough,5,0,4,-0.007985907222548445,9,3.1699250014423126
notable,1,0,1,-0.0001174398120963021,2,1.0
despairing,1,0,0,-0.007751027598355844,1,0.0
degree,4,0,3,-0.007927187316500297,7,2.807354922057604
milieu,3,0,1,-0.015502055196711688,4,2.0
rigor,1,0,1,-0.0001174398120963021,2,1.0
offsets,1,0,0,-0.007751027598355844,1,0.0
accomplished,2,0,3,0.0074574280681150885,5,2.321928094887362
inspiring,3,0,3,-0.0002348796241926042,6,2.584962500721156
ruinous,1,0,1,-0.0001174398120963021,2,1.0
hardscrabble,0,0,1,0.007574867880211391,1,0.0
insists,0,0,1,0.007574867880211391,1,0.0
margaret,0,0,1,0.007574867880211391,1,0.0
denying,0,0,2,0.015208455666470933,2,1.0
economic,0,0,2,0.015208455666470933,2,1.0
fringes,0,0,1,0.007574867880211391,1,0.0
thatcher,0,0,1,0.007574867880211391,1,0.0
express,0,0,3,0.022842043452730474,3,1.5849625007211563
tactfully,0,0,1,0.007574867880211391,1,0.0
pope,0,0,1,0.007574867880211391,1,0.0
melancholy,0,0,1,0.007574867880211391,1,0.0
resonate,1,0,2,0.0075161479741632405,3,1.5849625007211563
sad,7,0,9,0.01479741632413388,16,4.0
andrew,0,0,3,0.022842043452730474,3,1.5849625007211563
dickson,0,0,1,0.007574867880211391,1,0.0
generosity,0,0,2,0.015208455666470933,2,1.0
resolute,0,0,1,0.007574867880211391,1,0.0
frame,4,0,4,-0.00029359953024075264,8,3.0
comforting,0,0,2,0.015208455666470933,2,1.0
marmite,0,0,1,0.007574867880211391,1,0.0
exception,3,0,2,-0.007868467410452145,5,2.321928094887362
feast,0,0,4,0.03047563123899002,4,2.0
dysfunction,0,0,1,0.007574867880211391,1,0.0
jar,3,0,1,-0.015502055196711688,4,2.0
slathered,1,0,1,-0.0001174398120963021,2,1.0
crackers,0,0,1,0.007574867880211391,1,0.0
blighter,0,0,1,0.007574867880211391,1,0.0
endure,1,0,2,0.0075161479741632405,3,1.5849625007211563
hyper,2,0,2,-0.00017615971814445228,4,2.0
depressed,1,0,0,-0.007751027598355844,1,0.0
price,7,0,8,0.007163828537874339,15,3.9068905956085187
mostly,10,0,11,0.006987668819729884,21,4.392317422778761
inarticulate,3,0,0,-0.02313564298297123,3,1.5849625007211563
impressively,0,0,2,0.015208455666470933,2,1.0
gawky,0,0,1,0.007574867880211391,1,0.0
easily,10,0,16,0.04515560775102759,26,4.700439718141093
somber,1,0,2,0.0075161479741632405,3,1.5849625007211563
ironies,0,0,2,0.015208455666470933,2,1.0
wistful,1,0,1,-0.0001174398120963021,2,1.0
unrelieved,0,0,1,0.007574867880211391,1,0.0
richly,0,0,4,0.03047563123899002,4,2.0
snappy,0,0,3,0.022842043452730474,3,1.5849625007211563
volatile,0,0,3,0.022842043452730474,3,1.5849625007211563
rewarded,1,0,1,-0.0001174398120963021,2,1.0
opportunities,3,0,3,-0.0002348796241926042,6,2.584962500721156
liners,0,0,1,0.007574867880211391,1,0.0
opinion,1,0,3,0.015149735760422781,4,2.0
respectable,2,0,5,0.022724603640634174,7,2.807354922057604
analyze,6,0,7,0.007222548443922484,13,3.700439718141092
sums,1,0,0,-0.007751027598355844,1,0.0
reaction,1,0,1,-0.0001174398120963021,2,1.0
b,11,0,26,0.11379917792131533,37,5.20945336562895
tunes,1,0,1,-0.0001174398120963021,2,1.0
dated,1,0,0,-0.007751027598355844,1,0.0
unfunny,11,0,0,-0.08467410452143277,11,3.4594316186372978
makers,5,0,2,-0.02325308279506753,7,2.807354922057604
demonstrate,1,0,2,0.0075161479741632405,3,1.5849625007211563
sopranos,1,0,0,-0.007751027598355844,1,0.0
incredibly,5,0,1,-0.030886670581327075,6,2.584962500721156
buddies,1,0,0,-0.007751027598355844,1,0.0
mismatched,1,0,0,-0.007751027598355844,1,0.0
map,1,0,0,-0.007751027598355844,1,0.0
bounces,1,0,1,-0.0001174398120963021,2,1.0
endless,2,0,2,-0.00017615971814445228,4,2.0
spelling,0,0,1,0.007574867880211391,1,0.0
poster,2,0,2,-0.00017615971814445228,4,2.0
release,6,0,3,-0.023311802701115682,9,3.1699250014423126
comedies,5,0,16,0.08361714621256605,21,4.392317422778761
honestly,2,0,3,0.0074574280681150885,5,2.321928094887362
maybe,12,0,11,-0.008396946564885502,23,4.523561956057013
gleaned,1,0,0,-0.007751027598355844,1,0.0
decent,7,0,9,0.01479741632413388,16,4.0
laughs,20,0,21,0.006400469759248378,41,5.357552004618084
squeeze,2,0,1,-0.007809747504403995,3,1.5849625007211563
sing,2,0,0,-0.015443335290663537,2,1.0
swings,3,0,0,-0.02313564298297123,3,1.5849625007211563
successes,1,0,0,-0.007751027598355844,1,0.0
waters,1,0,1,-0.0001174398120963021,2,1.0
regurgitates,1,0,0,-0.007751027598355844,1,0.0
shown,3,0,0,-0.02313564298297123,3,1.5849625007211563
familiar,12,0,20,0.060305343511450366,32,5.0
visible,3,0,0,-0.02313564298297123,3,1.5849625007211563
superfluous,1,0,0,-0.007751027598355844,1,0.0
mighty,1,0,0,-0.007751027598355844,1,0.0
appointed,1,0,0,-0.007751027598355844,1,0.0
sequelplagued,1,0,0,-0.007751027598355844,1,0.0
enthusiasm,2,0,2,-0.00017615971814445228,4,2.0
ramis,1,0,0,-0.007751027598355844,1,0.0
dirigir,1,0,0,-0.007751027598355844,1,0.0
saído,1,0,0,-0.007751027598355844,1,0.0
cama,1,0,0,-0.007751027598355844,1,0.0
pé,1,0,0,-0.007751027598355844,1,0.0
harold,1,0,1,-0.0001174398120963021,2,1.0
continuação,1,0,0,-0.007751027598355844,1,0.0
da,3,0,2,-0.007868467410452145,5,2.321928094887362
aqueles,1,0,0,-0.007751027598355844,1,0.0
este,2,0,0,-0.015443335290663537,2,1.0
deve,1,0,0,-0.007751027598355844,1,0.0
assistir,1,0,0,-0.007751027598355844,1,0.0
com,2,0,1,-0.007809747504403995,3,1.5849625007211563
decidiram,1,0,0,-0.007751027598355844,1,0.0
também,1,0,2,0.0075161479741632405,3,1.5849625007211563
em,10,0,6,-0.031180270111567827,16,4.0
filme,3,0,3,-0.0002348796241926042,6,2.584962500721156
o,8,0,11,0.02237228420434527,19,4.247927513443585
esta,1,0,0,-0.007751027598355844,1,0.0
esquerdo,1,0,0,-0.007751027598355844,1,0.0
ter,1,0,0,-0.007751027598355844,1,0.0
aceitou,1,0,0,-0.007751027598355844,1,0.0
verse,0,0,1,0.007574867880211391,1,0.0
coulda,0,0,2,0.015208455666470933,2,1.0
therapy,0,0,2,0.015208455666470933,2,1.0
seeing,8,0,8,-0.0005284791544333534,16,4.0
laugh,16,0,18,0.014268937169700513,34,5.08746284125034
guess,6,0,0,-0.04621256605989431,6,2.584962500721156
crass,4,0,2,-0.015560775102759838,6,2.584962500721156
sequels,4,0,5,0.007339988256018788,9,3.1699250014423126
affection,2,0,1,-0.007809747504403995,3,1.5849625007211563
contrived,13,0,2,-0.08479154433352908,15,3.9068905956085187
unnecessary,6,0,0,-0.04621256605989431,6,2.584962500721156
retreada,1,0,0,-0.007751027598355844,1,0.0
copy,6,0,1,-0.03857897827363477,7,2.807354922057604
stale,12,0,0,-0.09236641221374046,12,3.5849625007211565
rehashing,1,0,0,-0.007751027598355844,1,0.0
excited,1,0,0,-0.007751027598355844,1,0.0
basically,4,0,1,-0.023194362889019382,5,2.321928094887362
teaming,0,0,1,0.007574867880211391,1,0.0
chemically,0,0,1,0.007574867880211391,1,0.0
incongruous,2,0,1,-0.007809747504403995,3,1.5849625007211563
bullets,2,0,4,0.015091015854374633,6,2.584962500721156
worrying,2,0,0,-0.015443335290663537,2,1.0
sweating,1,0,1,-0.0001174398120963021,2,1.0
deniro,4,0,0,-0.030827950675278923,4,2.0
distasteful,2,0,0,-0.015443335290663537,2,1.0
semi,2,0,0,-0.015443335290663537,2,1.0
equally,6,0,6,-0.00041103934233705647,12,3.5849625007211565
lyrics,1,0,0,-0.007751027598355844,1,0.0
jet,2,0,0,-0.015443335290663537,2,1.0
overblown,5,0,0,-0.038520258367586616,5,2.321928094887362
lines,9,0,6,-0.023487962419260135,15,3.9068905956085187
formula,15,0,14,-0.008573106283029958,29,4.857980995127573
lazier,0,0,1,0.007574867880211391,1,0.0
redeemed,0,0,1,0.007574867880211391,1,0.0
hinge,0,0,1,0.007574867880211391,1,0.0
padded,1,0,0,-0.007751027598355844,1,0.0
goombah,1,0,0,-0.007751027598355844,1,0.0
viterelli,1,0,0,-0.007751027598355844,1,0.0
proceeds,0,0,2,0.015208455666470933,2,1.0
level,18,0,13,-0.03928361714621258,31,4.954196310386876
declines,0,0,1,0.007574867880211391,1,0.0
unified,2,0,0,-0.015443335290663537,2,1.0
thumbs,2,0,2,-0.00017615971814445228,4,2.0
friggin,1,0,0,-0.007751027598355844,1,0.0
grumpy,1,0,0,-0.007751027598355844,1,0.0
heard,5,0,1,-0.030886670581327075,6,2.584962500721156
demographic,4,0,0,-0.030827950675278923,4,2.0
possibly,7,0,3,-0.031004110393423375,10,3.3219280948873626
striking,2,0,8,0.0456253669994128,10,3.3219280948873626
solidly,1,0,2,0.0075161479741632405,3,1.5849625007211563
hobbled,1,0,0,-0.007751027598355844,1,0.0
baked,1,0,1,-0.0001174398120963021,2,1.0
setups,3,0,0,-0.02313564298297123,3,1.5849625007211563
pacing,9,0,3,-0.046388725778038764,12,3.5849625007211565
retread,8,0,1,-0.05396359365825015,9,3.1699250014423126
sluggish,1,0,0,-0.007751027598355844,1,0.0
sleepwalk,1,0,0,-0.007751027598355844,1,0.0
vulgarities,1,0,0,-0.007751027598355844,1,0.0
refuse,1,0,0,-0.007751027598355844,1,0.0
antwone,5,0,4,-0.007985907222548445,9,3.1699250014423126
newcomer,0,0,2,0.015208455666470933,2,1.0
demands,1,0,4,0.022783323546682326,5,2.321928094887362
caring,0,0,1,0.007574867880211391,1,0.0
tissues,0,0,1,0.007574867880211391,1,0.0
compellingly,0,0,2,0.015208455666470933,2,1.0
miracle,1,0,3,0.015149735760422781,4,2.0
obstacles,1,0,2,0.0075161479741632405,3,1.5849625007211563
minor,1,0,5,0.030416911332941866,6,2.584962500721156
trivial,1,0,0,-0.007751027598355844,1,0.0
cliched,8,0,1,-0.05396359365825015,9,3.1699250014423126
lean,0,0,4,0.03047563123899002,4,2.0
denzel,2,0,3,0.0074574280681150885,5,2.321928094887362
considerable,3,0,5,0.015032295948326481,8,3.0
competent,2,0,4,0.015091015854374633,6,2.584962500721156
unremarkable,1,0,1,-0.0001174398120963021,2,1.0
planned,1,0,0,-0.007751027598355844,1,0.0
damon,2,0,0,-0.015443335290663537,2,1.0
residuals,1,0,0,-0.007751027598355844,1,0.0
completes,1,0,0,-0.007751027598355844,1,0.0
structure,7,0,3,-0.031004110393423375,10,3.3219280948873626
meat,1,0,1,-0.0001174398120963021,2,1.0
earnest,8,0,4,-0.031062830299471524,12,3.5849625007211565
effort,11,0,10,-0.00833822665883735,21,4.392317422778761
potatoes,1,0,1,-0.0001174398120963021,2,1.0
hallmark,1,0,1,-0.0001174398120963021,2,1.0
hokey,2,0,0,-0.015443335290663537,2,1.0
taste,11,0,6,-0.03887257780387552,17,4.08746284125034
keen,1,0,1,-0.0001174398120963021,2,1.0
reflected,0,0,2,0.015208455666470933,2,1.0
solidity,0,0,1,0.007574867880211391,1,0.0
sturdiness,0,0,1,0.007574867880211391,1,0.0
associated,1,0,3,0.015149735760422781,4,2.0
pat,0,0,3,0.022842043452730474,3,1.5849625007211563
inspirational,0,0,3,0.022842043452730474,3,1.5849625007211563
elevates,1,0,4,0.022783323546682326,5,2.321928094887362
shortcomings,0,0,2,0.015208455666470933,2,1.0
confronted,0,0,1,0.007574867880211391,1,0.0
waythat,0,0,1,0.007574867880211391,1,0.0
bared,0,0,1,0.007574867880211391,1,0.0
conventions,2,0,1,-0.007809747504403995,3,1.5849625007211563
manipulation,2,0,1,-0.007809747504403995,3,1.5849625007211563
stoops,0,0,1,0.007574867880211391,1,0.0
victories,0,0,1,0.007574867880211391,1,0.0
protagonist,3,0,2,-0.007868467410452145,5,2.321928094887362
corny,2,0,6,0.030358191426893714,8,3.0
celebrate,0,0,1,0.007574867880211391,1,0.0
exceptions,0,0,1,0.007574867880211391,1,0.0
tender,0,0,3,0.022842043452730474,3,1.5849625007211563
yearning,1,0,3,0.015149735760422781,4,2.0
troubled,1,0,1,-0.0001174398120963021,2,1.0
origins,0,0,1,0.007574867880211391,1,0.0
acceptance,0,0,1,0.007574867880211391,1,0.0
capability,0,0,1,0.007574867880211391,1,0.0
effecting,0,0,1,0.007574867880211391,1,0.0
pic,4,0,5,0.007339988256018788,9,3.1699250014423126
splendidly,1,0,3,0.015149735760422781,4,2.0
illustrates,1,0,2,0.0075161479741632405,3,1.5849625007211563
adversity,0,0,1,0.007574867880211391,1,0.0
pancakes,1,0,1,-0.0001174398120963021,2,1.0
aircraft,1,0,0,-0.007751027598355844,1,0.0
sentimentalized,1,0,0,-0.007751027598355844,1,0.0
carrier,1,0,0,-0.007751027598355844,1,0.0
intelligence,12,0,10,-0.016030534351145043,22,4.459431618637297
sympathy,3,0,3,-0.0002348796241926042,6,2.584962500721156
doubt,3,0,5,0.015032295948326481,8,3.0
celebrates,1,0,5,0.030416911332941866,6,2.584962500721156
ethnicity,0,0,1,0.007574867880211391,1,0.0
measured,0,0,3,0.022842043452730474,3,1.5849625007211563
intensity,1,0,9,0.06095126247798004,10,3.3219280948873626
crafted,3,0,7,0.030299471520845563,10,3.3219280948873626
emotionally,5,0,10,0.037815619495008806,15,3.9068905956085187
onscreen,2,0,2,-0.00017615971814445228,4,2.0
eventual,1,0,4,0.022783323546682326,5,2.321928094887362
foregoes,0,0,1,0.007574867880211391,1,0.0
tricky,0,0,2,0.015208455666470933,2,1.0
maneuvers,1,0,2,0.0075161479741632405,3,1.5849625007211563
welled,0,0,1,0.007574867880211391,1,0.0
heartbreaking,0,0,4,0.03047563123899002,4,2.0
tears,1,0,3,0.015149735760422781,4,2.0
personnel,0,0,1,0.007574867880211391,1,0.0
prey,0,0,1,0.007574867880211391,1,0.0
trappings,4,0,3,-0.007927187316500297,7,2.807354922057604
dubious,2,0,0,-0.015443335290663537,2,1.0
feat,3,0,3,-0.0002348796241926042,6,2.584962500721156
particularly,6,0,3,-0.023311802701115682,9,3.1699250014423126
cinematically,0,0,2,0.015208455666470933,2,1.0
quietly,2,0,2,-0.00017615971814445228,4,2.0
stuffed,1,0,1,-0.0001174398120963021,2,1.0
stunt,8,0,0,-0.061597181444509694,8,3.0
tackles,1,0,3,0.015149735760422781,4,2.0
compassion,2,0,5,0.022724603640634174,7,2.807354922057604
ambition,3,0,3,-0.0002348796241926042,6,2.584962500721156
supply,1,0,1,-0.0001174398120963021,2,1.0
seriousness,0,0,2,0.015208455666470933,2,1.0
crises,0,0,1,0.007574867880211391,1,0.0
egoyan,5,0,8,0.022548443922489725,13,3.700439718141092
faceless,0,0,1,0.007574867880211391,1,0.0
tormented,1,0,2,0.0075161479741632405,3,1.5849625007211563
heritage,0,0,3,0.022842043452730474,3,1.5849625007211563
diluted,1,0,0,-0.007751027598355844,1,0.0
impact,5,0,8,0.022548443922489725,13,3.700439718141092
genocide,2,0,1,-0.007809747504403995,3,1.5849625007211563
closure,1,0,2,0.0075161479741632405,3,1.5849625007211563
twentieth,1,0,0,-0.007751027598355844,1,0.0
credits,5,0,4,-0.007985907222548445,9,3.1699250014423126
roll,2,0,3,0.0074574280681150885,5,2.321928094887362
curiosity,1,0,1,-0.0001174398120963021,2,1.0
enigmatic,0,0,1,0.007574867880211391,1,0.0
shifting,2,0,1,-0.007809747504403995,3,1.5849625007211563
outrage,2,0,3,0.0074574280681150885,5,2.321928094887362
repercussions,0,0,1,0.007574867880211391,1,0.0
impression,3,0,3,-0.0002348796241926042,6,2.584962500721156
fabric,2,0,2,-0.00017615971814445228,4,2.0
deepen,0,0,1,0.007574867880211391,1,0.0
ideas,11,0,5,-0.04650616559013506,16,4.0
rendering,0,0,1,0.007574867880211391,1,0.0
ararat,3,0,3,-0.0002348796241926042,6,2.584962500721156
multilayered,0,0,1,0.007574867880211391,1,0.0
conjured,0,0,1,0.007574867880211391,1,0.0
atom,0,0,2,0.015208455666470933,2,1.0
massacre,1,0,1,-0.0001174398120963021,2,1.0
linking,1,0,1,-0.0001174398120963021,2,1.0
bites,1,0,1,-0.0001174398120963021,2,1.0
worthy,4,0,12,0.06077510275983558,16,4.0
chew,1,0,2,0.0075161479741632405,3,1.5849625007211563
armenians,0,0,1,0.007574867880211391,1,0.0
inspires,1,0,2,0.0075161479741632405,3,1.5849625007211563
intersect,0,0,1,0.007574867880211391,1,0.0
boldly,0,0,1,0.007574867880211391,1,0.0
monumental,1,0,2,0.0075161479741632405,3,1.5849625007211563
regards,1,0,1,-0.0001174398120963021,2,1.0
gut,0,0,6,0.0457428068115091,6,2.584962500721156
indulgent,6,0,3,-0.023311802701115682,9,3.1699250014423126
toxic,2,0,2,-0.00017615971814445228,4,2.0
canadians,0,0,1,0.007574867880211391,1,0.0
uncommonly,1,0,5,0.030416911332941866,6,2.584962500721156
fiercely,0,0,1,0.007574867880211391,1,0.0
ambitious,5,0,6,0.007281268349970636,11,3.4594316186372978
doubting,1,0,0,-0.007751027598355844,1,0.0
clumsy,9,0,0,-0.06928948913681739,9,3.1699250014423126
confusing,2,0,1,-0.007809747504403995,3,1.5849625007211563
broached,0,0,1,0.007574867880211391,1,0.0
adaptations,0,0,3,0.022842043452730474,3,1.5849625007211563
towering,0,0,2,0.015208455666470933,2,1.0
strengths,2,0,1,-0.007809747504403995,3,1.5849625007211563
significance,0,0,2,0.015208455666470933,2,1.0
heartedly,0,0,1,0.007574867880211391,1,0.0
mychael,0,0,1,0.007574867880211391,1,0.0
danna,0,0,1,0.007574867880211391,1,0.0
rewards,1,0,1,-0.0001174398120963021,2,1.0
bountiful,0,0,1,0.007574867880211391,1,0.0
patience,2,0,5,0.022724603640634174,7,2.807354922057604
passionately,1,0,0,-0.007751027598355844,1,0.0
teaching,1,0,0,-0.007751027598355844,1,0.0
timelines,1,0,0,-0.007751027598355844,1,0.0
ponderous,2,0,1,-0.007809747504403995,3,1.5849625007211563
puzzle,1,0,0,-0.007751027598355844,1,0.0
nor,25,0,3,-0.16946564885496185,28,4.807354922057604
monument,2,0,0,-0.015443335290663537,2,1.0
gained,2,0,0,-0.015443335290663537,2,1.0
wanted,8,0,6,-0.015795654726952442,14,3.8073549220576037
exist,3,0,0,-0.02313564298297123,3,1.5849625007211563
inform,2,0,0,-0.015443335290663537,2,1.0
educate,1,0,0,-0.007751027598355844,1,0.0
astray,2,0,0,-0.015443335290663537,2,1.0
armenia,1,0,0,-0.007751027598355844,1,0.0
subplots,3,0,0,-0.02313564298297123,3,1.5849625007211563
heresy,1,0,0,-0.007751027598355844,1,0.0
excuse,8,0,1,-0.05396359365825015,9,3.1699250014423126
involvement,2,0,0,-0.015443335290663537,2,1.0
intellectually,4,0,0,-0.030827950675278923,4,2.0
sustain,7,0,3,-0.031004110393423375,10,3.3219280948873626
considers,2,0,0,-0.015443335290663537,2,1.0
larger,3,0,4,0.00739870816206694,7,2.807354922057604
labyrinthine,1,0,0,-0.007751027598355844,1,0.0
defeats,2,0,1,-0.007809747504403995,3,1.5849625007211563
pays,1,0,2,0.0075161479741632405,3,1.5849625007211563
gamesmanship,0,0,2,0.015208455666470933,2,1.0
extremely,8,0,7,-0.008162066940692901,15,3.9068905956085187
inextricably,1,0,1,-0.0001174398120963021,2,1.0
unavailable,1,0,0,-0.007751027598355844,1,0.0
rut,2,0,0,-0.015443335290663537,2,1.0
metaphors,1,0,1,-0.0001174398120963021,2,1.0
mechanics,2,0,0,-0.015443335290663537,2,1.0
closet,1,0,2,0.0075161479741632405,3,1.5849625007211563
bumping,1,0,0,-0.007751027598355844,1,0.0
sight,6,0,3,-0.023311802701115682,9,3.1699250014423126
resorting,1,0,3,0.015149735760422781,4,2.0
energy,8,0,13,0.03763945977686435,21,4.392317422778761
prevail,0,0,1,0.007574867880211391,1,0.0
shamelessly,2,0,1,-0.007809747504403995,3,1.5849625007211563
related,1,0,1,-0.0001174398120963021,2,1.0
myer,0,0,1,0.007574867880211391,1,0.0
grimace,0,0,1,0.007574867880211391,1,0.0
silliness,3,0,3,-0.0002348796241926042,6,2.584962500721156
pee,1,0,1,-0.0001174398120963021,2,1.0
tarantino,0,0,1,0.007574867880211391,1,0.0
franchise,10,0,7,-0.023546682325308287,17,4.08746284125034
adolescent,4,0,4,-0.00029359953024075264,8,3.0
dirty,3,0,7,0.030299471520845563,10,3.3219280948873626
riffs,0,0,1,0.007574867880211391,1,0.0
pyrite,1,0,0,-0.007751027598355844,1,0.0
riff,1,0,0,-0.007751027598355844,1,0.0
lengthy,1,0,0,-0.007751027598355844,1,0.0
numbingly,5,0,0,-0.038520258367586616,5,2.321928094887362
subjected,1,0,1,-0.0001174398120963021,2,1.0
poo,1,0,0,-0.007751027598355844,1,0.0
gag,4,0,1,-0.023194362889019382,5,2.321928094887362
kinda,3,0,2,-0.007868467410452145,5,2.321928094887362
factory,2,0,0,-0.015443335290663537,2,1.0
chocolate,1,0,1,-0.0001174398120963021,2,1.0
roach,1,0,0,-0.007751027598355844,1,0.0
pictures,7,0,5,-0.01573693482090429,12,3.5849625007211565
visual,12,0,14,0.01450381679389312,26,4.700439718141093
taxicab,1,0,0,-0.007751027598355844,1,0.0
despairingly,1,0,0,-0.007751027598355844,1,0.0
unimpressive,1,0,0,-0.007751027598355844,1,0.0
mildly,9,0,1,-0.061655901350557846,10,3.3219280948873626
yeah,0,0,1,0.007574867880211391,1,0.0
obviousness,0,0,1,0.007574867880211391,1,0.0
stupidity,5,0,1,-0.030886670581327075,6,2.584962500721156
inventiveness,0,0,3,0.022842043452730474,3,1.5849625007211563
either,10,0,10,-0.0006459189665296572,20,4.321928094887363
franchisethen,1,0,0,-0.007751027598355844,1,0.0
sequence,5,0,3,-0.01561949500880799,8,3.0
spoofing,1,0,2,0.0075161479741632405,3,1.5849625007211563
m,17,0,11,-0.046858485026423966,28,4.807354922057604
cameo,2,0,1,-0.007809747504403995,3,1.5849625007211563
ruins,4,0,0,-0.030827950675278923,4,2.0
likely,20,0,12,-0.0623018203170875,32,5.0
theatre,1,0,3,0.015149735760422781,4,2.0
inventive,1,0,6,0.03805049911920141,7,2.807354922057604
annoying,7,0,1,-0.04627128596594246,8,3.0
repeated,3,0,1,-0.015502055196711688,4,2.0
letting,4,0,3,-0.007927187316500297,7,2.807354922057604
ripping,1,0,1,-0.0001174398120963021,2,1.0
consciously,2,0,0,-0.015443335290663537,2,1.0
flaws,1,0,19,0.13728714034057546,20,4.321928094887363
sideways,0,0,1,0.007574867880211391,1,0.0
sibling,0,0,2,0.015208455666470933,2,1.0
squared,0,0,1,0.007574867880211391,1,0.0
rivalry,1,0,1,-0.0001174398120963021,2,1.0
third,8,0,4,-0.031062830299471524,12,3.5849625007211565
charmyeah,0,0,1,0.007574867880211391,1,0.0
established,0,0,4,0.03047563123899002,4,2.0
liberties,0,0,1,0.007574867880211391,1,0.0
goofiest,0,0,1,0.007574867880211391,1,0.0
unsuccessful,1,0,0,-0.007751027598355844,1,0.0
accompanying,3,0,0,-0.02313564298297123,3,1.5849625007211563
crudeness,1,0,0,-0.007751027598355844,1,0.0
redundancy,1,0,0,-0.007751027598355844,1,0.0
cotton,2,0,0,-0.015443335290663537,2,1.0
unsatisfied,2,0,0,-0.015443335290663537,2,1.0
sticky,3,0,0,-0.02313564298297123,3,1.5849625007211563
fluffy,1,0,1,-0.0001174398120963021,2,1.0
binging,1,0,0,-0.007751027598355844,1,0.0
justify,2,0,2,-0.00017615971814445228,4,2.0
embarrassment,7,0,1,-0.04627128596594246,8,3.0
barf,1,0,1,-0.0001174398120963021,2,1.0
moviehouse,0,0,1,0.007574867880211391,1,0.0
bag,8,0,1,-0.05396359365825015,9,3.1699250014423126
qualities,1,0,1,-0.0001174398120963021,2,1.0
irritating,4,0,2,-0.015560775102759838,6,2.584962500721156
consistently,2,0,6,0.030358191426893714,8,3.0
mold,1,0,3,0.015149735760422781,4,2.0
fashioned,3,0,12,0.06846741045214327,15,3.9068905956085187
inspiration,5,0,2,-0.02325308279506753,7,2.807354922057604
conscious,2,0,3,0.0074574280681150885,5,2.321928094887362
uneven,5,0,7,0.014914856136230177,12,3.5849625007211565
spoof,5,0,4,-0.007985907222548445,9,3.1699250014423126
mod,0,0,1,0.007574867880211391,1,0.0
predecessors,2,0,4,0.015091015854374633,6,2.584962500721156
gall,0,0,1,0.007574867880211391,1,0.0
wreck,2,0,2,-0.00017615971814445228,4,2.0
collision,0,0,3,0.022842043452730474,3,1.5849625007211563
clamoring,0,0,1,0.007574867880211391,1,0.0
tastelessness,0,0,2,0.015208455666470933,2,1.0
fans,18,0,32,0.1057545507927187,50,5.643856189774724
barrage,0,0,3,0.022842043452730474,3,1.5849625007211563
fizzled,0,0,1,0.007574867880211391,1,0.0
overlook,0,0,2,0.015208455666470933,2,1.0
littering,0,0,1,0.007574867880211391,1,0.0
stick,2,0,1,-0.007809747504403995,3,1.5849625007211563
aim,1,0,3,0.015149735760422781,4,2.0
authentic,3,0,3,-0.0002348796241926042,6,2.584962500721156
write,2,0,2,-0.00017615971814445228,4,2.0
schrader,0,0,5,0.03810921902524956,5,2.321928094887362
latter,3,0,1,-0.015502055196711688,4,2.0
biopic,3,0,5,0.015032295948326481,8,3.0
celebrity,0,0,4,0.03047563123899002,4,2.0
addiction,0,0,1,0.007574867880211391,1,0.0
harrowing,1,0,2,0.0075161479741632405,3,1.5849625007211563
annihilation,0,0,1,0.007574867880211391,1,0.0
willem,0,0,1,0.007574867880211391,1,0.0
dafoe,0,0,3,0.022842043452730474,3,1.5849625007211563
flavor,0,0,3,0.022842043452730474,3,1.5849625007211563
caliber,1,0,2,0.0075161479741632405,3,1.5849625007211563
matched,1,0,2,0.0075161479741632405,3,1.5849625007211563
downfall,0,0,1,0.007574867880211391,1,0.0
compulsively,1,0,1,-0.0001174398120963021,2,1.0
sordid,0,0,1,0.007574867880211391,1,0.0
sterile,1,0,1,-0.0001174398120963021,2,1.0
unreachable,0,0,1,0.007574867880211391,1,0.0
telescope,0,0,1,0.007574867880211391,1,0.0
devices,1,0,2,0.0075161479741632405,3,1.5849625007211563
subtle,4,0,6,0.014973576042278329,10,3.3219280948873626
relies,2,0,3,0.0074574280681150885,5,2.321928094887362
convey,1,0,2,0.0075161479741632405,3,1.5849625007211563
tradition,2,0,4,0.015091015854374633,6,2.584962500721156
evolves,0,0,2,0.015208455666470933,2,1.0
playboy,1,0,1,-0.0001174398120963021,2,1.0
swingers,0,0,1,0.007574867880211391,1,0.0
glimpse,0,0,4,0.03047563123899002,4,2.0
downbeat,1,0,1,-0.0001174398120963021,2,1.0
hammers,1,0,0,-0.007751027598355844,1,0.0
moralistic,1,0,0,-0.007751027598355844,1,0.0
thespian,0,0,1,0.007574867880211391,1,0.0
flexible,0,0,2,0.015208455666470933,2,1.0
whittle,0,0,1,0.007574867880211391,1,0.0
nuances,0,0,3,0.022842043452730474,3,1.5849625007211563
supremely,0,0,1,0.007574867880211391,1,0.0
lasting,1,0,1,-0.0001174398120963021,2,1.0
adept,1,0,1,-0.0001174398120963021,2,1.0
unless,7,0,1,-0.04627128596594246,8,3.0
tremendous,0,0,2,0.015208455666470933,2,1.0
denial,0,0,2,0.015208455666470933,2,1.0
fledged,0,0,1,0.007574867880211391,1,0.0
addict,0,0,3,0.022842043452730474,3,1.5849625007211563
careers,0,0,2,0.015208455666470933,2,1.0
pass,7,0,1,-0.04627128596594246,8,3.0
opera,9,0,6,-0.023487962419260135,15,3.9068905956085187
typical,4,0,4,-0.00029359953024075264,8,3.0
downward,1,0,2,0.0075161479741632405,3,1.5849625007211563
bears,2,0,1,-0.007809747504403995,3,1.5849625007211563
tepid,3,0,2,-0.007868467410452145,5,2.321928094887362
effective,2,0,14,0.09142689371697005,16,4.0
examines,0,0,2,0.015208455666470933,2,1.0
candor,0,0,1,0.007574867880211391,1,0.0
unblinking,0,0,2,0.015208455666470933,2,1.0
decline,0,0,1,0.007574867880211391,1,0.0
crushingly,0,0,1,0.007574867880211391,1,0.0
poignancy,2,0,3,0.0074574280681150885,5,2.321928094887362
bustingly,0,0,1,0.007574867880211391,1,0.0
unsettling,2,0,8,0.0456253669994128,10,3.3219280948873626
exploratory,0,0,1,0.007574867880211391,1,0.0
manabout,0,0,1,0.007574867880211391,1,0.0
procedure,0,0,2,0.015208455666470933,2,1.0
autopsy,0,0,2,0.015208455666470933,2,1.0
defining,0,0,1,0.007574867880211391,1,0.0
nary,2,0,0,-0.015443335290663537,2,1.0
glimmer,1,0,0,-0.007751027598355844,1,0.0
specimen,1,0,2,0.0075161479741632405,3,1.5849625007211563
chilly,2,0,2,-0.00017615971814445228,4,2.0
clinical,1,0,0,-0.007751027598355844,1,0.0
script,57,0,25,-0.2322959483264827,82,6.357552004618085
gerbosi,0,0,1,0.007574867880211391,1,0.0
economically,0,0,1,0.007574867880211391,1,0.0
oddly,2,0,4,0.015091015854374633,6,2.584962500721156
portrayal,0,0,6,0.0457428068115091,6,2.584962500721156
losers,0,0,2,0.015208455666470933,2,1.0
compulsive,0,0,2,0.015208455666470933,2,1.0
hypnotic,0,0,6,0.0457428068115091,6,2.584962500721156
blurred,0,0,1,0.007574867880211391,1,0.0
lacked,1,0,0,-0.007751027598355844,1,0.0
answer,4,0,0,-0.030827950675278923,4,2.0
amused,1,0,4,0.022783323546682326,5,2.321928094887362
dawson,0,0,2,0.015208455666470933,2,1.0
am,1,0,5,0.030416911332941866,6,2.584962500721156
portray,1,0,2,0.0075161479741632405,3,1.5849625007211563
richard,2,0,5,0.022724603640634174,7,2.807354922057604
drags,4,0,2,-0.015560775102759838,6,2.584962500721156
tried,4,0,1,-0.023194362889019382,5,2.321928094887362
mechanical,6,0,0,-0.04621256605989431,6,2.584962500721156
squarely,3,0,2,-0.007868467410452145,5,2.321928094887362
wanes,1,0,1,-0.0001174398120963021,2,1.0
hopkinsdoesn,1,0,0,-0.007751027598355844,1,0.0
fax,2,0,0,-0.015443335290663537,2,1.0
please,6,0,3,-0.023311802701115682,9,3.1699250014423126
joel,3,0,2,-0.007868467410452145,5,2.321928094887362
overproduced,2,0,0,-0.015443335290663537,2,1.0
bruckheimer,4,0,2,-0.015560775102759838,6,2.584962500721156
demographically,1,0,0,-0.007751027598355844,1,0.0
wildly,6,0,1,-0.03857897827363477,7,2.807354922057604
jerry,5,0,1,-0.030886670581327075,6,2.584962500721156
shallow,7,0,4,-0.02337052260716383,11,3.4594316186372978
inadequately,1,0,0,-0.007751027598355844,1,0.0
targeted,2,0,0,-0.015443335290663537,2,1.0
schumacher,2,0,1,-0.007809747504403995,3,1.5849625007211563
styles,1,0,2,0.0075161479741632405,3,1.5849625007211563
motivated,3,0,1,-0.015502055196711688,4,2.0
spliced,2,0,0,-0.015443335290663537,2,1.0
somebody,2,0,2,-0.00017615971814445228,4,2.0
riddled,1,0,1,-0.0001174398120963021,2,1.0
nonsense,4,0,1,-0.023194362889019382,5,2.321928094887362
jettisons,1,0,0,-0.007751027598355844,1,0.0
strained,1,0,0,-0.007751027598355844,1,0.0
chaotic,5,0,0,-0.038520258367586616,5,2.321928094887362
pairing,1,0,0,-0.007751027598355844,1,0.0
sound,8,0,7,-0.008162066940692901,15,3.9068905956085187
theorybut,1,0,0,-0.007751027598355844,1,0.0
showtime,11,0,4,-0.0541397533763946,15,3.9068905956085187
ok,0,0,2,0.015208455666470933,2,1.0
sir,1,0,0,-0.007751027598355844,1,0.0
bitch,1,0,0,-0.007751027598355844,1,0.0
saying,4,0,5,0.007339988256018788,9,3.1699250014423126
intrinsically,1,0,0,-0.007751027598355844,1,0.0
stupidities,1,0,0,-0.007751027598355844,1,0.0
sticking,3,0,0,-0.02313564298297123,3,1.5849625007211563
decoder,1,0,0,-0.007751027598355844,1,0.0
paste,2,0,1,-0.007809747504403995,3,1.5849625007211563
cut,6,0,7,0.007222548443922484,13,3.700439718141092
cutter,2,0,1,-0.007809747504403995,3,1.5849625007211563
cookie,3,0,0,-0.02313564298297123,3,1.5849625007211563
stolid,3,0,2,-0.007868467410452145,5,2.321928094887362
contrast,1,0,1,-0.0001174398120963021,2,1.0
fizzle,1,0,0,-0.007751027598355844,1,0.0
schticky,1,0,0,-0.007751027598355844,1,0.0
bland,12,0,3,-0.06946564885496184,15,3.9068905956085187
unpaid,1,0,0,-0.007751027598355844,1,0.0
typed,1,0,0,-0.007751027598355844,1,0.0
intern,1,0,0,-0.007751027598355844,1,0.0
wonder,8,0,9,0.0071051086318261875,17,4.08746284125034
univac,1,0,0,-0.007751027598355844,1,0.0
8,3,0,0,-0.02313564298297123,3,1.5849625007211563
tea,1,0,1,-0.0001174398120963021,2,1.0
baaaaaaaaad,1,0,0,-0.007751027598355844,1,0.0
shear,1,0,0,-0.007751027598355844,1,0.0
cup,1,0,0,-0.007751027598355844,1,0.0
mean,11,0,4,-0.0541397533763946,15,3.9068905956085187
word,6,0,2,-0.030945390487375223,8,3.0
demeanour,1,0,0,-0.007751027598355844,1,0.0
comedian,3,0,0,-0.02313564298297123,3,1.5849625007211563
contrasts,1,0,0,-0.007751027598355844,1,0.0
sip,0,0,1,0.007574867880211391,1,0.0
week,8,0,1,-0.05396359365825015,9,3.1699250014423126
ivory,0,0,1,0.007574867880211391,1,0.0
merchant,1,0,1,-0.0001174398120963021,2,1.0
vintage,3,0,4,0.00739870816206694,7,2.807354922057604
productions,2,0,2,-0.00017615971814445228,4,2.0
iced,0,0,1,0.007574867880211391,1,0.0
wines,0,0,1,0.007574867880211391,1,0.0
sedentary,1,0,0,-0.007751027598355844,1,0.0
doldrums,1,0,0,-0.007751027598355844,1,0.0
momentary,1,0,0,-0.007751027598355844,1,0.0
skinny,2,0,1,-0.007809747504403995,3,1.5849625007211563
umpteenth,1,0,0,-0.007751027598355844,1,0.0
dip,2,0,0,-0.015443335290663537,2,1.0
pond,1,0,0,-0.007751027598355844,1,0.0
twaddle,2,0,1,-0.007809747504403995,3,1.5849625007211563
putrid,2,0,0,-0.015443335290663537,2,1.0
earthly,1,0,0,-0.007751027598355844,1,0.0
market,4,0,3,-0.007927187316500297,7,2.807354922057604
assume,2,0,0,-0.015443335290663537,2,1.0
costly,1,0,0,-0.007751027598355844,1,0.0
stoop,1,0,0,-0.007751027598355844,1,0.0
techno,2,0,1,-0.007809747504403995,3,1.5849625007211563
tripe,1,0,0,-0.007751027598355844,1,0.0
predictably,4,0,1,-0.023194362889019382,5,2.321928094887362
soulless,5,0,1,-0.030886670581327075,6,2.584962500721156
holes,11,0,2,-0.06940692894891369,13,3.700439718141092
screenplays,2,0,0,-0.015443335290663537,2,1.0
moronic,2,0,1,-0.007809747504403995,3,1.5849625007211563
staleness,1,0,0,-0.007751027598355844,1,0.0
luck,2,0,0,-0.015443335290663537,2,1.0
jams,1,0,0,-0.007751027598355844,1,0.0
lackluster,6,0,0,-0.04621256605989431,6,2.584962500721156
derivativeness,1,0,0,-0.007751027598355844,1,0.0
blatant,1,0,0,-0.007751027598355844,1,0.0
scenario,4,0,1,-0.023194362889019382,5,2.321928094887362
winded,2,0,1,-0.007809747504403995,3,1.5849625007211563
personas,0,0,1,0.007574867880211391,1,0.0
anyone,30,0,15,-0.11632413388138581,45,5.491853096329675
gunfest,1,0,0,-0.007751027598355844,1,0.0
flocking,1,0,0,-0.007751027598355844,1,0.0
actual,2,0,0,-0.015443335290663537,2,1.0
imitation,4,0,3,-0.007927187316500297,7,2.807354922057604
tension,4,0,4,-0.00029359953024075264,8,3.0
tree,1,0,1,-0.0001174398120963021,2,1.0
spray,2,0,0,-0.015443335290663537,2,1.0
zero,5,0,0,-0.038520258367586616,5,2.321928094887362
gunplay,2,0,0,-0.015443335290663537,2,1.0
storyline,3,0,3,-0.0002348796241926042,6,2.584962500721156
damage,10,0,4,-0.04644744568408691,14,3.8073549220576037
treatises,1,0,0,-0.007751027598355844,1,0.0
thoughtful,1,0,8,0.053317674691720496,9,3.1699250014423126
intelligible,1,0,0,-0.007751027598355844,1,0.0
devoid,8,0,0,-0.061597181444509694,8,3.0
collateral,9,0,2,-0.054022313564298305,11,3.4594316186372978
vs,9,0,2,-0.054022313564298305,11,3.4594316186372978
unimaginative,7,0,0,-0.053904873752202,7,2.807354922057604
superficial,8,0,2,-0.04633000587199061,10,3.3219280948873626
titles,2,0,3,0.0074574280681150885,5,2.321928094887362
sporting,2,0,0,-0.015443335290663537,2,1.0
terrible,8,0,4,-0.031062830299471524,12,3.5849625007211565
banal,6,0,0,-0.04621256605989431,6,2.584962500721156
convenient,3,0,0,-0.02313564298297123,3,1.5849625007211563
kaos,2,0,0,-0.015443335290663537,2,1.0
contender,2,0,0,-0.015443335290663537,2,1.0
noise,2,0,0,-0.015443335290663537,2,1.0
jangle,1,0,0,-0.007751027598355844,1,0.0
deer,1,0,0,-0.007751027598355844,1,0.0
explosions,5,0,1,-0.030886670581327075,6,2.584962500721156
safe,1,0,3,0.015149735760422781,4,2.0
dumb,23,0,11,-0.09301233118027012,34,5.08746284125034
cranky,1,0,1,-0.0001174398120963021,2,1.0
crap,6,0,0,-0.04621256605989431,6,2.584962500721156
ticket,4,0,3,-0.007927187316500297,7,2.807354922057604
lame,11,0,1,-0.07704051673517323,12,3.5849625007211565
severely,2,0,0,-0.015443335290663537,2,1.0
eckstraordinarily,1,0,0,-0.007751027598355844,1,0.0
screening,4,0,0,-0.030827950675278923,4,2.0
outage,1,0,0,-0.007751027598355844,1,0.0
bus,1,0,0,-0.007751027598355844,1,0.0
entertained,1,0,6,0.03805049911920141,7,2.807354922057604
parking,2,0,0,-0.015443335290663537,2,1.0
needed,4,0,7,0.02260716382853787,11,3.4594316186372978
suffers,9,0,4,-0.038755137991779216,13,3.700439718141092
shoot,9,0,1,-0.061655901350557846,10,3.3219280948873626
lifeless,5,0,0,-0.038520258367586616,5,2.321928094887362
loud,21,0,5,-0.123429242513212,26,4.700439718141093
unintentional,5,0,1,-0.030886670581327075,6,2.584962500721156
unbearably,2,0,1,-0.007809747504403995,3,1.5849625007211563
unattractive,1,0,0,-0.007751027598355844,1,0.0
utterly,10,0,6,-0.031180270111567827,16,4.0
shambles,2,0,0,-0.015443335290663537,2,1.0
sillyits,1,0,0,-0.007751027598355844,1,0.0
sheen,1,0,2,0.0075161479741632405,3,1.5849625007211563
stillborn,1,0,0,-0.007751027598355844,1,0.0
beaten,3,0,1,-0.015502055196711688,4,2.0
worn,4,0,1,-0.023194362889019382,5,2.321928094887362
sucked,2,0,0,-0.015443335290663537,2,1.0
admission,2,0,4,0.015091015854374633,6,2.584962500721156
ah,2,0,1,-0.007809747504403995,3,1.5849625007211563
urge,3,0,1,-0.015502055196711688,4,2.0
doze,3,0,0,-0.02313564298297123,3,1.5849625007211563
battles,1,0,1,-0.0001174398120963021,2,1.0
backyard,1,0,0,-0.007751027598355844,1,0.0
plastic,2,0,0,-0.015443335290663537,2,1.0
believability,3,0,1,-0.015502055196711688,4,2.0
ordeal,2,0,0,-0.015443335290663537,2,1.0
palm,1,0,0,-0.007751027598355844,1,0.0
wouldn,8,0,1,-0.05396359365825015,9,3.1699250014423126
egg,2,0,0,-0.015443335290663537,2,1.0
required,3,0,3,-0.0002348796241926042,6,2.584962500721156
boil,1,0,0,-0.007751027598355844,1,0.0
coherent,3,0,1,-0.015502055196711688,4,2.0
collected,2,0,0,-0.015443335290663537,2,1.0
faceoff,1,0,0,-0.007751027598355844,1,0.0
seconds,3,0,0,-0.02313564298297123,3,1.5849625007211563
magician,1,0,0,-0.007751027598355844,1,0.0
pileup,2,0,0,-0.015443335290663537,2,1.0
blown,4,0,1,-0.023194362889019382,5,2.321928094887362
hadn,2,0,1,-0.007809747504403995,3,1.5849625007211563
list,3,0,4,0.00739870816206694,7,2.807354922057604
visceral,2,0,6,0.030358191426893714,8,3.0
vague,3,0,0,-0.02313564298297123,3,1.5849625007211563
kick,3,0,3,-0.0002348796241926042,6,2.584962500721156
knockout,2,0,2,-0.00017615971814445228,4,2.0
explosion,2,0,1,-0.007809747504403995,3,1.5849625007211563
timed,1,0,1,-0.0001174398120963021,2,1.0
numbing,1,0,0,-0.007751027598355844,1,0.0
horrendously,1,0,0,-0.007751027598355844,1,0.0
plainly,2,0,0,-0.015443335290663537,2,1.0
incomprehensible,3,0,0,-0.02313564298297123,3,1.5849625007211563
amateurish,2,0,0,-0.015443335290663537,2,1.0
likeable,0,0,3,0.022842043452730474,3,1.5849625007211563
enjoyed,0,0,4,0.03047563123899002,4,2.0
impart,1,0,1,-0.0001174398120963021,2,1.0
pummel,1,0,0,-0.007751027598355844,1,0.0
ilk,0,0,1,0.007574867880211391,1,0.0
banter,2,0,3,0.0074574280681150885,5,2.321928094887362
mclaughlin,0,0,1,0.007574867880211391,1,0.0
barbers,0,0,1,0.007574867880211391,1,0.0
streetwise,0,0,1,0.007574867880211391,1,0.0
inoffensive,5,0,4,-0.007985907222548445,9,3.1699250014423126
timeless,0,0,2,0.015208455666470933,2,1.0
pratfalls,4,0,3,-0.007927187316500297,7,2.807354922057604
hairpiece,0,0,1,0.007574867880211391,1,0.0
urban,2,0,7,0.037991779213153255,9,3.1699250014423126
towers,0,0,1,0.007574867880211391,1,0.0
didn,17,0,13,-0.031591309453904884,30,4.906890595608519
survived,1,0,0,-0.007751027598355844,1,0.0
smile,1,0,4,0.022783323546682326,5,2.321928094887362
charmer,0,0,3,0.022842043452730474,3,1.5849625007211563
camaraderie,0,0,1,0.007574867880211391,1,0.0
traditions,0,0,1,0.007574867880211391,1,0.0
heartwarming,0,0,6,0.0457428068115091,6,2.584962500721156
consider,9,0,2,-0.054022313564298305,11,3.4594316186372978
nonjudgmental,0,0,2,0.015208455666470933,2,1.0
shines,1,0,4,0.022783323546682326,5,2.321928094887362
veteran,1,0,2,0.0075161479741632405,3,1.5849625007211563
tuned,0,0,3,0.022842043452730474,3,1.5849625007211563
laudable,1,0,0,-0.007751027598355844,1,0.0
deals,2,0,4,0.015091015854374633,6,2.584962500721156
comedic,6,0,3,-0.023311802701115682,9,3.1699250014423126
button,2,0,0,-0.015443335290663537,2,1.0
context,3,0,0,-0.02313564298297123,3,1.5849625007211563
burlesque,1,0,1,-0.0001174398120963021,2,1.0
fades,0,0,1,0.007574867880211391,1,0.0
dramedy,0,0,2,0.015208455666470933,2,1.0
slices,0,0,1,0.007574867880211391,1,0.0
dismiss,1,0,1,-0.0001174398120963021,2,1.0
rental,4,0,2,-0.015560775102759838,6,2.584962500721156
per,1,0,0,-0.007751027598355844,1,0.0
swipe,2,0,1,-0.007809747504403995,3,1.5849625007211563
variety,2,0,3,0.0074574280681150885,5,2.321928094887362
occasionally,8,0,11,0.02237228420434527,19,4.247927513443585
breezy,0,0,4,0.03047563123899002,4,2.0
102,0,0,1,0.007574867880211391,1,0.0
boisterous,0,0,2,0.015208455666470933,2,1.0
tim,0,0,2,0.015208455666470933,2,1.0
needn,1,0,2,0.0075161479741632405,3,1.5849625007211563
jive,1,0,0,-0.007751027598355844,1,0.0
outdated,2,0,0,-0.015443335290663537,2,1.0
hippest,1,0,0,-0.007751027598355844,1,0.0
sitcom,8,0,1,-0.05396359365825015,9,3.1699250014423126
swagger,1,0,0,-0.007751027598355844,1,0.0
boasts,3,0,3,-0.0002348796241926042,6,2.584962500721156
shuck,1,0,0,-0.007751027598355844,1,0.0
hottest,1,0,0,-0.007751027598355844,1,0.0
beacon,1,0,1,-0.0001174398120963021,2,1.0
folks,6,0,3,-0.023311802701115682,9,3.1699250014423126
chances,3,0,2,-0.007868467410452145,5,2.321928094887362
rowdily,0,0,1,0.007574867880211391,1,0.0
wins,3,0,2,-0.007868467410452145,5,2.321928094887362
vitality,0,0,5,0.03810921902524956,5,2.321928094887362
verdict,1,0,0,-0.007751027598355844,1,0.0
underlying,1,0,3,0.015149735760422781,4,2.0
richer,0,0,2,0.015208455666470933,2,1.0
deftly,0,0,5,0.03810921902524956,5,2.321928094887362
anticipated,1,0,2,0.0075161479741632405,3,1.5849625007211563
uproarious,0,0,1,0.007574867880211391,1,0.0
decibel,0,0,1,0.007574867880211391,1,0.0
likable,1,0,4,0.022783323546682326,5,2.321928094887362
pushiness,0,0,1,0.007574867880211391,1,0.0
volume,1,0,1,-0.0001174398120963021,2,1.0
fatter,0,0,1,0.007574867880211391,1,0.0
underscore,1,0,1,-0.0001174398120963021,2,1.0
populist,0,0,1,0.007574867880211391,1,0.0
amid,2,0,2,-0.00017615971814445228,4,2.0
familial,0,0,4,0.03047563123899002,4,2.0
pressed,2,0,2,-0.00017615971814445228,4,2.0
lively,0,0,3,0.022842043452730474,3,1.5849625007211563
entertains,0,0,3,0.022842043452730474,3,1.5849625007211563
values,5,0,9,0.030182031708749266,14,3.8073549220576037
glow,0,0,3,0.022842043452730474,3,1.5849625007211563
reassuring,0,0,2,0.015208455666470933,2,1.0
uplifter,0,0,1,0.007574867880211391,1,0.0
sweetness,1,0,5,0.030416911332941866,6,2.584962500721156
resembling,1,0,2,0.0075161479741632405,3,1.5849625007211563
mixture,2,0,2,-0.00017615971814445228,4,2.0
static,1,0,1,-0.0001174398120963021,2,1.0
fluidly,0,0,1,0.007574867880211391,1,0.0
results,2,0,6,0.030358191426893714,8,3.0
gambol,0,0,1,0.007574867880211391,1,0.0
regarding,2,0,1,-0.007809747504403995,3,1.5849625007211563
iconic,0,0,1,0.007574867880211391,1,0.0
revelations,1,0,3,0.015149735760422781,4,2.0
twohy,0,0,6,0.0457428068115091,6,2.584962500721156
skilled,0,0,2,0.015208455666470933,2,1.0
maintaining,0,0,1,0.007574867880211391,1,0.0
chock,0,0,1,0.007574867880211391,1,0.0
slightly,7,0,7,-0.0004697592483852084,14,3.8073549220576037
seaworthy,0,0,1,0.007574867880211391,1,0.0
chiller,2,0,3,0.0074574280681150885,5,2.321928094887362
noir,0,0,4,0.03047563123899002,4,2.0
homages,0,0,2,0.015208455666470933,2,1.0
mood,2,0,12,0.07615971814445097,14,3.8073549220576037
gripping,4,0,10,0.0455079271873165,14,3.8073549220576037
substance,7,0,3,-0.031004110393423375,10,3.3219280948873626
nonetheless,0,0,7,0.05337639459776864,7,2.807354922057604
seat,2,0,8,0.0456253669994128,10,3.3219280948873626
twilight,0,0,1,0.007574867880211391,1,0.0
exceedingly,1,0,2,0.0075161479741632405,3,1.5849625007211563
criminally,0,0,1,0.007574867880211391,1,0.0
crackles,0,0,1,0.007574867880211391,1,0.0
claustrophobia,0,0,1,0.007574867880211391,1,0.0
sooner,0,0,1,0.007574867880211391,1,0.0
supernatural,1,0,1,-0.0001174398120963021,2,1.0
spookiness,0,0,1,0.007574867880211391,1,0.0
combine,0,0,3,0.022842043452730474,3,1.5849625007211563
gaping,2,0,0,-0.015443335290663537,2,1.0
sink,3,0,0,-0.02313564298297123,3,1.5849625007211563
compels,0,0,1,0.007574867880211391,1,0.0
yarn,3,0,6,0.022665883734586022,9,3.1699250014423126
spinner,0,0,1,0.007574867880211391,1,0.0
distinctly,2,0,1,-0.007809747504403995,3,1.5849625007211563
shivers,1,0,0,-0.007751027598355844,1,0.0
drown,1,0,0,-0.007751027598355844,1,0.0
spine,1,0,1,-0.0001174398120963021,2,1.0
parmore,1,0,0,-0.007751027598355844,1,0.0
atmosphere,2,0,2,-0.00017615971814445228,4,2.0
spits,1,0,1,-0.0001174398120963021,2,1.0
net,0,0,3,0.022842043452730474,3,1.5849625007211563
bermuda,0,0,1,0.007574867880211391,1,0.0
northwest,0,0,1,0.007574867880211391,1,0.0
triangle,0,0,1,0.007574867880211391,1,0.0
underwater,0,0,1,0.007574867880211391,1,0.0
grizzled,0,0,1,0.007574867880211391,1,0.0
charred,0,0,1,0.007574867880211391,1,0.0
casts,0,0,4,0.03047563123899002,4,2.0
direct,3,0,2,-0.007868467410452145,5,2.321928094887362
toes,0,0,3,0.022842043452730474,3,1.5849625007211563
exercise,13,0,8,-0.03899001761597182,21,4.392317422778761
chilling,0,0,5,0.03810921902524956,5,2.321928094887362
preserving,0,0,1,0.007574867880211391,1,0.0
claustrophobic,0,0,4,0.03047563123899002,4,2.0
payoff,4,0,1,-0.023194362889019382,5,2.321928094887362
appreciated,1,0,2,0.0075161479741632405,3,1.5849625007211563
sailors,0,0,1,0.007574867880211391,1,0.0
wink,0,0,1,0.007574867880211391,1,0.0
imagining,0,0,1,0.007574867880211391,1,0.0
logic,5,0,6,0.007281268349970636,11,3.4594316186372978
postmodern,0,0,2,0.015208455666470933,2,1.0
ghosts,3,0,3,-0.0002348796241926042,6,2.584962500721156
warped,1,0,1,-0.0001174398120963021,2,1.0
sardine,0,0,1,0.007574867880211391,1,0.0
freaky,0,0,4,0.03047563123899002,4,2.0
satisfyingly,0,0,1,0.007574867880211391,1,0.0
scarifying,0,0,2,0.015208455666470933,2,1.0
fresh,8,0,13,0.03763945977686435,21,4.392317422778761
mileage,0,0,1,0.007574867880211391,1,0.0
phonograph,0,0,1,0.007574867880211391,1,0.0
mundane,2,0,2,-0.00017615971814445228,4,2.0
blast,1,0,7,0.04568408690546095,8,3.0
barrel,1,0,1,-0.0001174398120963021,2,1.0
inflate,0,0,1,0.007574867880211391,1,0.0
understatement,0,0,2,0.015208455666470933,2,1.0
pitch,3,0,4,0.00739870816206694,7,2.807354922057604
eerie,1,0,3,0.015149735760422781,4,2.0
payoffs,1,0,1,-0.0001174398120963021,2,1.0
aground,0,0,1,0.007574867880211391,1,0.0
snared,0,0,1,0.007574867880211391,1,0.0
distances,1,0,0,-0.007751027598355844,1,0.0
register,2,0,0,-0.015443335290663537,2,1.0
false,6,0,3,-0.023311802701115682,9,3.1699250014423126
herrings,1,0,0,-0.007751027598355844,1,0.0
throwing,2,0,3,0.0074574280681150885,5,2.321928094887362
intriguing,2,0,9,0.053258954785672344,11,3.4594316186372978
malediction,1,0,0,-0.007751027598355844,1,0.0
popcorn,3,0,14,0.08373458602466236,17,4.08746284125034
surrounding,2,0,1,-0.007809747504403995,3,1.5849625007211563
sustenance,1,0,0,-0.007751027598355844,1,0.0
crypt,1,0,0,-0.007751027598355844,1,0.0
overlong,2,0,1,-0.007809747504403995,3,1.5849625007211563
undiminished,0,0,1,0.007574867880211391,1,0.0
emergence,0,0,2,0.015208455666470933,2,1.0
experiment,1,0,2,0.0075161479741632405,3,1.5849625007211563
hallucinatory,0,0,1,0.007574867880211391,1,0.0
design,3,0,3,-0.0002348796241926042,6,2.584962500721156
displaying,0,0,2,0.015208455666470933,2,1.0
establishes,0,0,4,0.03047563123899002,4,2.0
sen,1,0,2,0.0075161479741632405,3,1.5849625007211563
amounts,0,0,2,0.015208455666470933,2,1.0
stifle,0,0,1,0.007574867880211391,1,0.0
spot,2,0,4,0.015091015854374633,6,2.584962500721156
perspective,0,0,1,0.007574867880211391,1,0.0
canvass,0,0,1,0.007574867880211391,1,0.0
wittier,0,0,1,0.007574867880211391,1,0.0
infinitely,0,0,1,0.007574867880211391,1,0.0
bueller,0,0,1,0.007574867880211391,1,0.0
crafty,0,0,1,0.007574867880211391,1,0.0
ferris,0,0,1,0.007574867880211391,1,0.0
energetic,4,0,10,0.0455079271873165,14,3.8073549220576037
leaden,4,0,0,-0.030827950675278923,4,2.0
simple,5,0,8,0.022548443922489725,13,3.700439718141092
confounds,0,0,1,0.007574867880211391,1,0.0
yearcoasts,0,0,1,0.007574867880211391,1,0.0
happiest,0,0,1,0.007574867880211391,1,0.0
fitfully,4,0,0,-0.030827950675278923,4,2.0
romp,2,0,5,0.022724603640634174,7,2.807354922057604
malcolm,1,0,2,0.0075161479741632405,3,1.5849625007211563
pubescent,2,0,0,-0.015443335290663537,2,1.0
giggle,1,0,4,0.022783323546682326,5,2.321928094887362
rarest,0,0,1,0.007574867880211391,1,0.0
oriented,1,0,4,0.022783323546682326,5,2.321928094887362
flck,1,0,0,-0.007751027598355844,1,0.0
implausible,6,0,0,-0.04621256605989431,6,2.584962500721156
raised,1,0,1,-0.0001174398120963021,2,1.0
remembers,1,0,1,-0.0001174398120963021,2,1.0
laid,0,0,6,0.0457428068115091,6,2.584962500721156
basic,2,0,6,0.030358191426893714,8,3.0
expected,6,0,7,0.007222548443922484,13,3.700439718141092
continuity,2,0,0,-0.015443335290663537,2,1.0
reasonably,4,0,0,-0.030827950675278923,4,2.0
grader,1,0,0,-0.007751027598355844,1,0.0
eighth,2,0,0,-0.015443335290663537,2,1.0
errors,1,0,0,-0.007751027598355844,1,0.0
credible,2,0,1,-0.007809747504403995,3,1.5849625007211563
pleasing,1,0,5,0.030416911332941866,6,2.584962500721156
tolerable,0,0,1,0.007574867880211391,1,0.0
lark,1,0,3,0.015149735760422781,4,2.0
adults,10,0,15,0.03752201996476805,25,4.643856189774724
wised,1,0,0,-0.007751027598355844,1,0.0
tame,2,0,0,-0.015443335290663537,2,1.0
channel,3,0,0,-0.02313564298297123,3,1.5849625007211563
shattering,1,0,3,0.015149735760422781,4,2.0
unusually,2,0,1,-0.007809747504403995,3,1.5849625007211563
talked,0,0,1,0.007574867880211391,1,0.0
accomplishment,0,0,4,0.03047563123899002,4,2.0
obnoxious,5,0,2,-0.02325308279506753,7,2.807354922057604
precocious,1,0,1,-0.0001174398120963021,2,1.0
involve,3,0,0,-0.02313564298297123,3,1.5849625007211563
plastered,1,0,0,-0.007751027598355844,1,0.0
tap,2,0,3,0.0074574280681150885,5,2.321928094887362
futile,1,0,0,-0.007751027598355844,1,0.0
sensibilities,2,0,4,0.015091015854374633,6,2.584962500721156
kiddie,4,0,1,-0.023194362889019382,5,2.321928094887362
annex,1,0,0,-0.007751027598355844,1,0.0
lungs,1,0,0,-0.007751027598355844,1,0.0
screams,1,0,0,-0.007751027598355844,1,0.0
behave,2,0,0,-0.015443335290663537,2,1.0
inhabit,2,0,1,-0.007809747504403995,3,1.5849625007211563
effect,6,0,3,-0.023311802701115682,9,3.1699250014423126
sellouts,1,0,0,-0.007751027598355844,1,0.0
recruitment,1,0,0,-0.007751027598355844,1,0.0
dan,1,0,0,-0.007751027598355844,1,0.0
substitute,3,0,0,-0.02313564298297123,3,1.5849625007211563
shawn,1,0,0,-0.007751027598355844,1,0.0
primary,1,0,1,-0.0001174398120963021,2,1.0
colors,3,0,4,0.00739870816206694,7,2.807354922057604
bite,6,0,1,-0.03857897827363477,7,2.807354922057604
levy,2,0,1,-0.007809747504403995,3,1.5849625007211563
schneider,1,0,0,-0.007751027598355844,1,0.0
types,2,0,2,-0.00017615971814445228,4,2.0
compendium,2,0,0,-0.015443335290663537,2,1.0
thumpingly,2,0,0,-0.015443335290663537,2,1.0
gleefully,1,0,1,-0.0001174398120963021,2,1.0
baloney,1,0,0,-0.007751027598355844,1,0.0
biz,3,0,1,-0.015502055196711688,4,2.0
phony,2,0,0,-0.015443335290663537,2,1.0
hyperbolic,1,0,0,-0.007751027598355844,1,0.0
pulling,3,0,1,-0.015502055196711688,4,2.0
reminded,0,0,3,0.022842043452730474,3,1.5849625007211563
studios,3,0,0,-0.02313564298297123,3,1.5849625007211563
giant,6,0,6,-0.00041103934233705647,12,3.5849625007211565
wickedly,1,0,2,0.0075161479741632405,3,1.5849625007211563
payback,1,0,2,0.0075161479741632405,3,1.5849625007211563
homage,1,0,4,0.022783323546682326,5,2.321928094887362
sonnenfeld,2,0,1,-0.007809747504403995,3,1.5849625007211563
teetering,0,0,2,0.015208455666470933,2,1.0
tight,1,0,3,0.015149735760422781,4,2.0
ticklingly,0,0,1,0.007574867880211391,1,0.0
ridiculous,7,0,4,-0.02337052260716383,11,3.4594316186372978
extra,2,0,3,0.0074574280681150885,5,2.321928094887362
substantial,1,0,2,0.0075161479741632405,3,1.5849625007211563
85,0,0,2,0.015208455666470933,2,1.0
butter,0,0,1,0.007574867880211391,1,0.0
screwball,2,0,2,-0.00017615971814445228,4,2.0
tub,1,0,2,0.0075161479741632405,3,1.5849625007211563
brisk,2,0,5,0.022724603640634174,7,2.807354922057604
streamlined,0,0,1,0.007574867880211391,1,0.0
logical,0,0,2,0.015208455666470933,2,1.0
fly,3,0,4,0.00739870816206694,7,2.807354922057604
loopholes,0,0,1,0.007574867880211391,1,0.0
caffeinated,0,0,1,0.007574867880211391,1,0.0
funnier,5,0,6,0.007281268349970636,11,3.4594316186372978
frantic,5,0,1,-0.030886670581327075,6,2.584962500721156
invisible,0,0,1,0.007574867880211391,1,0.0
skit,1,0,0,-0.007751027598355844,1,0.0
deposited,1,0,0,-0.007751027598355844,1,0.0
fervently,2,0,0,-0.015443335290663537,2,1.0
shoddy,3,0,0,-0.02313564298297123,3,1.5849625007211563
colorful,3,0,10,0.05320023487962419,13,3.700439718141092
meanderings,1,0,1,-0.0001174398120963021,2,1.0
sequences,11,0,7,-0.03123899001761598,18,4.169925001442312
lots,10,0,4,-0.04644744568408691,14,3.8073549220576037
role,9,0,19,0.07574867880211392,28,4.807354922057604
plenty,3,0,5,0.015032295948326481,8,3.0
hogs,0,0,1,0.007574867880211391,1,0.0
outlandish,0,0,2,0.015208455666470933,2,1.0
coincidences,0,0,1,0.007574867880211391,1,0.0
amusingly,0,0,1,0.007574867880211391,1,0.0
overlapping,0,0,1,0.007574867880211391,1,0.0
forgettable,9,0,7,-0.015854374633000594,16,4.0
derives,0,0,1,0.007574867880211391,1,0.0
attendant,0,0,1,0.007574867880211391,1,0.0
draw,0,0,2,0.015208455666470933,2,1.0
pun,1,0,1,-0.0001174398120963021,2,1.0
entendre,0,0,1,0.007574867880211391,1,0.0
workman,0,0,1,0.007574867880211391,1,0.0
grasp,1,0,1,-0.0001174398120963021,2,1.0
myself,1,0,5,0.030416911332941866,6,2.584962500721156
current,1,0,2,0.0075161479741632405,3,1.5849625007211563
trifle,1,0,1,-0.0001174398120963021,2,1.0
performed,0,0,2,0.015208455666470933,2,1.0
entertainments,0,0,1,0.007574867880211391,1,0.0
humorous,1,0,2,0.0075161479741632405,3,1.5849625007211563
evoke,1,0,1,-0.0001174398120963021,2,1.0
parallels,0,0,2,0.015208455666470933,2,1.0
irritations,0,0,1,0.007574867880211391,1,0.0
irritation,0,0,1,0.007574867880211391,1,0.0
bonus,1,0,1,-0.0001174398120963021,2,1.0
used,5,0,2,-0.02325308279506753,7,2.807354922057604
theatrically,1,0,0,-0.007751027598355844,1,0.0
outtakes,2,0,0,-0.015443335290663537,2,1.0
dvd,4,0,1,-0.023194362889019382,5,2.321928094887362
pleasant,3,0,12,0.06846741045214327,15,3.9068905956085187
vignettes,1,0,0,-0.007751027598355844,1,0.0
zany,1,0,2,0.0075161479741632405,3,1.5849625007211563
asylum,1,0,0,-0.007751027598355844,1,0.0
taken,10,0,2,-0.061714621256606,12,3.5849625007211565
glorious,0,0,5,0.03810921902524956,5,2.321928094887362
considered,2,0,3,0.0074574280681150885,5,2.321928094887362
windup,1,0,0,-0.007751027598355844,1,0.0
dislike,1,0,0,-0.007751027598355844,1,0.0
natured,4,0,3,-0.007927187316500297,7,2.807354922057604
bumper,1,0,0,-0.007751027598355844,1,0.0
laughed,3,0,2,-0.007868467410452145,5,2.321928094887362
slapstick,6,0,6,-0.00041103934233705647,12,3.5849625007211565
screwy,1,0,0,-0.007751027598355844,1,0.0
convinced,3,0,0,-0.02313564298297123,3,1.5849625007211563
wacky,1,0,1,-0.0001174398120963021,2,1.0
ratio,1,0,0,-0.007751027598355844,1,0.0
favour,1,0,2,0.0075161479741632405,3,1.5849625007211563
mistakenly,1,0,0,-0.007751027598355844,1,0.0
tossing,1,0,1,-0.0001174398120963021,2,1.0
haphazard,4,0,0,-0.030827950675278923,4,2.0
spontaneity,2,0,0,-0.015443335290663537,2,1.0
achieve,2,0,1,-0.007809747504403995,3,1.5849625007211563
pot,3,0,0,-0.02313564298297123,3,1.5849625007211563
expense,2,0,3,0.0074574280681150885,5,2.321928094887362
functions,0,0,3,0.022842043452730474,3,1.5849625007211563
roundelay,0,0,1,0.007574867880211391,1,0.0
gator,0,0,1,0.007574867880211391,1,0.0
bashing,0,0,1,0.007574867880211391,1,0.0
interplay,0,0,1,0.007574867880211391,1,0.0
delightful,2,0,8,0.0456253669994128,10,3.3219280948873626
partnerships,0,0,2,0.015208455666470933,2,1.0
mention,2,0,3,0.0074574280681150885,5,2.321928094887362
circumstances,0,0,3,0.022842043452730474,3,1.5849625007211563
predicament,1,0,0,-0.007751027598355844,1,0.0
precise,1,0,1,-0.0001174398120963021,2,1.0
unsympathetic,3,0,0,-0.02313564298297123,3,1.5849625007211563
generate,6,0,1,-0.03857897827363477,7,2.807354922057604
cleverly,2,0,0,-0.015443335290663537,2,1.0
uwe,2,0,0,-0.015443335290663537,2,1.0
boll,2,0,0,-0.015443335290663537,2,1.0
blah,1,0,0,-0.007751027598355844,1,0.0
klein,3,0,0,-0.02313564298297123,3,1.5849625007211563
crude,3,0,3,-0.0002348796241926042,6,2.584962500721156
throwback,2,0,5,0.022724603640634174,7,2.807354922057604
scant,2,0,0,-0.015443335290663537,2,1.0
potboiler,3,0,0,-0.02313564298297123,3,1.5849625007211563
guessed,0,0,2,0.015208455666470933,2,1.0
professional,2,0,2,-0.00017615971814445228,4,2.0
j,5,0,6,0.007281268349970636,11,3.4594316186372978
sandwich,0,0,1,0.007574867880211391,1,0.0
inviting,0,0,1,0.007574867880211391,1,0.0
boasting,1,0,2,0.0075161479741632405,3,1.5849625007211563
clint,2,0,1,-0.007809747504403995,3,1.5849625007211563
pb,0,0,1,0.007574867880211391,1,0.0
tasty,0,0,3,0.022842043452730474,3,1.5849625007211563
uneventful,2,0,1,-0.007809747504403995,3,1.5849625007211563
overly,4,0,3,-0.007927187316500297,7,2.807354922057604
phoney,1,0,0,-0.007751027598355844,1,0.0
sentiment,5,0,1,-0.030886670581327075,6,2.584962500721156
inducingly,1,0,0,-0.007751027598355844,1,0.0
winces,1,0,0,-0.007751027598355844,1,0.0
breath,2,0,5,0.022724603640634174,7,2.807354922057604
ahem,1,0,0,-0.007751027598355844,1,0.0
gasps,1,0,0,-0.007751027598355844,1,0.0
clutches,1,0,0,-0.007751027598355844,1,0.0
chest,4,0,1,-0.023194362889019382,5,2.321928094887362
assumes,2,0,1,-0.007809747504403995,3,1.5849625007211563
chops,1,0,3,0.015149735760422781,4,2.0
item,0,0,1,0.007574867880211391,1,0.0
classy,0,0,1,0.007574867880211391,1,0.0
barrow,1,0,0,-0.007751027598355844,1,0.0
clyde,1,0,0,-0.007751027598355844,1,0.0
serviceable,3,0,1,-0.015502055196711688,4,2.0
stiff,3,0,1,-0.015502055196711688,4,2.0
glacial,2,0,0,-0.015443335290663537,2,1.0
crosses,1,0,1,-0.0001174398120963021,2,1.0
protagoniststill,0,0,1,0.007574867880211391,1,0.0
diverting,3,0,3,-0.0002348796241926042,6,2.584962500721156
performing,1,0,0,-0.007751027598355844,1,0.0
uninvolving,2,0,0,-0.015443335290663537,2,1.0
collar,1,0,1,-0.0001174398120963021,2,1.0
stultifyingly,1,0,0,-0.007751027598355844,1,0.0
bloodwork,2,0,0,-0.015443335290663537,2,1.0
unrewarding,2,0,0,-0.015443335290663537,2,1.0
magnificent,1,0,2,0.0075161479741632405,3,1.5849625007211563
efficiently,2,0,1,-0.007809747504403995,3,1.5849625007211563
assert,1,0,0,-0.007751027598355844,1,0.0
slides,1,0,0,-0.007751027598355844,1,0.0
downhill,2,0,0,-0.015443335290663537,2,1.0
macho,1,0,2,0.0075161479741632405,3,1.5849625007211563
remember,7,0,4,-0.02337052260716383,11,3.4594316186372978
sadly,4,0,0,-0.030827950675278923,4,2.0
thrillers,2,0,3,0.0074574280681150885,5,2.321928094887362
endings,1,0,1,-0.0001174398120963021,2,1.0
twisting,1,0,2,0.0075161479741632405,3,1.5849625007211563
oozing,0,0,1,0.007574867880211391,1,0.0
unpredictable,0,0,2,0.015208455666470933,2,1.0
warming,0,0,2,0.015208455666470933,2,1.0
oncea,0,0,1,0.007574867880211391,1,0.0
moody,1,0,3,0.015149735760422781,4,2.0
roughshod,0,0,1,0.007574867880211391,1,0.0
suits,1,0,1,-0.0001174398120963021,2,1.0
geriatric,1,0,1,-0.0001174398120963021,2,1.0
wherein,0,0,1,0.007574867880211391,1,0.0
loyal,0,0,1,0.007574867880211391,1,0.0
incompetent,3,0,1,-0.015502055196711688,4,2.0
kicking,2,0,2,-0.00017615971814445228,4,2.0
liberated,0,0,2,0.015208455666470933,2,1.0
wielding,1,0,1,-0.0001174398120963021,2,1.0
magnum,0,0,1,0.007574867880211391,1,0.0
butt,1,0,1,-0.0001174398120963021,2,1.0
supporting,2,0,4,0.015091015854374633,6,2.584962500721156
weaker,1,0,0,-0.007751027598355844,1,0.0
moviemaking,1,0,4,0.022783323546682326,5,2.321928094887362
icon,2,0,1,-0.007809747504403995,3,1.5849625007211563
stumble,2,0,0,-0.015443335290663537,2,1.0
evident,0,0,2,0.015208455666470933,2,1.0
skillful,1,0,3,0.015149735760422781,4,2.0
percolating,0,0,2,0.015208455666470933,2,1.0
admire,2,0,2,-0.00017615971814445228,4,2.0
stately,0,0,2,0.015208455666470933,2,1.0
exasperated,0,0,1,0.007574867880211391,1,0.0
noticeable,0,0,2,0.015208455666470933,2,1.0
classicism,0,0,1,0.007574867880211391,1,0.0
solemnity,2,0,0,-0.015443335290663537,2,1.0
pump,2,0,0,-0.015443335290663537,2,1.0
laughable,4,0,0,-0.030827950675278923,4,2.0
overworked,1,0,0,-0.007751027598355844,1,0.0
twists,5,0,9,0.030182031708749266,14,3.8073549220576037
winds,3,0,2,-0.007868467410452145,5,2.321928094887362
professionalism,1,0,1,-0.0001174398120963021,2,1.0
lacks,17,0,12,-0.039224897240164425,29,4.857980995127573
doughty,0,0,1,0.007574867880211391,1,0.0
argued,0,0,1,0.007574867880211391,1,0.0
metaphysically,0,0,1,0.007574867880211391,1,0.0
dunit,0,0,1,0.007574867880211391,1,0.0
outset,0,0,1,0.007574867880211391,1,0.0
suppose,1,0,1,-0.0001174398120963021,2,1.0
vital,1,0,2,0.0075161479741632405,3,1.5849625007211563
universality,0,0,1,0.007574867880211391,1,0.0
exudes,1,0,1,-0.0001174398120963021,2,1.0
machines,0,0,2,0.015208455666470933,2,1.0
provokes,1,0,1,-0.0001174398120963021,2,1.0
nationalism,0,0,2,0.015208455666470933,2,1.0
accessible,2,0,4,0.015091015854374633,6,2.584962500721156
lesson,2,0,6,0.030358191426893714,8,3.0
disagreement,0,0,1,0.007574867880211391,1,0.0
undeniable,0,0,5,0.03810921902524956,5,2.321928094887362
forceful,0,0,1,0.007574867880211391,1,0.0
significant,1,0,3,0.015149735760422781,4,2.0
movingit,0,0,1,0.007574867880211391,1,0.0
historically,1,0,1,-0.0001174398120963021,2,1.0
astonishingly,1,0,1,-0.0001174398120963021,2,1.0
masterfully,0,0,3,0.022842043452730474,3,1.5849625007211563
prevention,0,0,1,0.007574867880211391,1,0.0
sunday,0,0,7,0.05337639459776864,7,2.807354922057604
accomplishes,0,0,2,0.015208455666470933,2,1.0
explaining,0,0,1,0.007574867880211391,1,0.0
linger,0,0,2,0.015208455666470933,2,1.0
ended,1,0,7,0.04568408690546095,8,3.0
shellshock,0,0,1,0.007574867880211391,1,0.0
shrapnel,0,0,1,0.007574867880211391,1,0.0
fiery,0,0,1,0.007574867880211391,1,0.0
characterizations,0,0,1,0.007574867880211391,1,0.0
thinness,1,0,1,-0.0001174398120963021,2,1.0
agitprop,1,0,1,-0.0001174398120963021,2,1.0
calm,0,0,2,0.015208455666470933,2,1.0
solemn,2,0,0,-0.015443335290663537,2,1.0
detached,1,0,1,-0.0001174398120963021,2,1.0
horrifying,1,0,2,0.0075161479741632405,3,1.5849625007211563
solace,0,0,1,0.007574867880211391,1,0.0
fierce,1,0,3,0.015149735760422781,4,2.0
merely,7,0,7,-0.0004697592483852084,14,3.8073549220576037
recount,1,0,1,-0.0001174398120963021,2,1.0
jerky,0,0,2,0.015208455666470933,2,1.0
held,2,0,3,0.0074574280681150885,5,2.321928094887362
nesbitt,0,0,2,0.015208455666470933,2,1.0
chaos,0,0,3,0.022842043452730474,3,1.5849625007211563
conflagration,0,0,1,0.007574867880211391,1,0.0
shaken,0,0,1,0.007574867880211391,1,0.0
fury,0,0,3,0.022842043452730474,3,1.5849625007211563
z,0,0,2,0.015208455666470933,2,1.0
throat,1,0,2,0.0075161479741632405,3,1.5849625007211563
algiers,0,0,2,0.015208455666470933,2,1.0
clutching,0,0,2,0.015208455666470933,2,1.0
stands,4,0,8,0.030240751614797418,12,3.5849625007211565
alongside,0,0,2,0.015208455666470933,2,1.0
connects,0,0,2,0.015208455666470933,2,1.0
counts,0,0,2,0.015208455666470933,2,1.0
transcends,0,0,6,0.0457428068115091,6,2.584962500721156
total,3,0,3,-0.0002348796241926042,6,2.584962500721156
authentically,1,0,1,-0.0001174398120963021,2,1.0
purposeless,1,0,0,-0.007751027598355844,1,0.0
pandemonium,1,0,0,-0.007751027598355844,1,0.0
simplistic,6,0,3,-0.023311802701115682,9,3.1699250014423126
sided,3,0,1,-0.015502055196711688,4,2.0
explanations,1,0,0,-0.007751027598355844,1,0.0
stylistically,1,0,0,-0.007751027598355844,1,0.0
collective,2,0,1,-0.007809747504403995,3,1.5849625007211563
flesh,0,0,3,0.022842043452730474,3,1.5849625007211563
combatants,0,0,1,0.007574867880211391,1,0.0
bubble,1,0,2,0.0075161479741632405,3,1.5849625007211563
primitive,0,0,1,0.007574867880211391,1,0.0
snowballs,0,0,1,0.007574867880211391,1,0.0
dizzying,0,0,1,0.007574867880211391,1,0.0
cooker,1,0,1,-0.0001174398120963021,2,1.0
thereafter,0,0,1,0.007574867880211391,1,0.0
memorial,0,0,1,0.007574867880211391,1,0.0
reconstruction,0,0,1,0.007574867880211391,1,0.0
fitting,1,0,2,0.0075161479741632405,3,1.5849625007211563
admirable,0,0,4,0.03047563123899002,4,2.0
torrent,0,0,1,0.007574867880211391,1,0.0
complications,0,0,1,0.007574867880211391,1,0.0
advocacy,0,0,1,0.007574867880211391,1,0.0
terrifying,1,0,3,0.015149735760422781,4,2.0
tad,2,0,0,-0.015443335290663537,2,1.0
greengrass,1,0,2,0.0075161479741632405,3,1.5849625007211563
intelligibility,1,0,0,-0.007751027598355844,1,0.0
devastatingly,0,0,1,0.007574867880211391,1,0.0
violently,0,0,1,0.007574867880211391,1,0.0
admired,0,0,2,0.015208455666470933,2,1.0
elegy,0,0,1,0.007574867880211391,1,0.0
bracing,0,0,2,0.015208455666470933,2,1.0
socio,0,0,2,0.015208455666470933,2,1.0
mullan,0,0,1,0.007574867880211391,1,0.0
forgoes,0,0,1,0.007574867880211391,1,0.0
frightening,2,0,2,-0.00017615971814445228,4,2.0
pulsating,0,0,2,0.015208455666470933,2,1.0
instinct,0,0,3,0.022842043452730474,3,1.5849625007211563
wallop,0,0,4,0.03047563123899002,4,2.0
duck,1,0,1,-0.0001174398120963021,2,1.0
immediacy,0,0,1,0.007574867880211391,1,0.0
engulfed,0,0,1,0.007574867880211391,1,0.0
earthy,0,0,1,0.007574867880211391,1,0.0
boldness,0,0,1,0.007574867880211391,1,0.0
pontecorvo,0,0,1,0.007574867880211391,1,0.0
gillo,0,0,1,0.007574867880211391,1,0.0
managed,0,0,3,0.022842043452730474,3,1.5849625007211563
cinematography,4,0,4,-0.00029359953024075264,8,3.0
stylistic,0,0,4,0.03047563123899002,4,2.0
tour,0,0,2,0.015208455666470933,2,1.0
undoubted,0,0,1,0.007574867880211391,1,0.0
lifts,0,0,2,0.015208455666470933,2,1.0
surfing,2,0,4,0.015091015854374633,6,2.584962500721156
subculture,0,0,1,0.007574867880211391,1,0.0
sport,1,0,1,-0.0001174398120963021,2,1.0
reverence,1,0,1,-0.0001174398120963021,2,1.0
adorned,0,0,1,0.007574867880211391,1,0.0
awesome,1,0,1,-0.0001174398120963021,2,1.0
washed,1,0,1,-0.0001174398120963021,2,1.0
stylings,0,0,1,0.007574867880211391,1,0.0
scripting,0,0,2,0.015208455666470933,2,1.0
sumptuous,1,0,1,-0.0001174398120963021,2,1.0
stockwell,0,0,1,0.007574867880211391,1,0.0
muscles,0,0,1,0.007574867880211391,1,0.0
gidget,0,0,1,0.007574867880211391,1,0.0
smarts,0,0,1,0.007574867880211391,1,0.0
camerawork,1,0,2,0.0075161479741632405,3,1.5849625007211563
cheerful,2,0,0,-0.015443335290663537,2,1.0
scenery,2,0,1,-0.007809747504403995,3,1.5849625007211563
sunburn,1,0,0,-0.007751027598355844,1,0.0
inspire,4,0,3,-0.007927187316500297,7,2.807354922057604
built,4,0,1,-0.023194362889019382,5,2.321928094887362
remarkable,4,0,7,0.02260716382853787,11,3.4594316186372978
soundtrack,9,0,2,-0.054022313564298305,11,3.4594316186372978
unending,1,0,0,-0.007751027598355844,1,0.0
downtime,1,0,0,-0.007751027598355844,1,0.0
vertical,2,0,0,-0.015443335290663537,2,1.0
limit,2,0,1,-0.007809747504403995,3,1.5849625007211563
doppelganger,0,0,1,0.007574867880211391,1,0.0
flex,0,0,1,0.007574867880211391,1,0.0
estrogen,1,0,1,-0.0001174398120963021,2,1.0
feminine,0,0,1,0.007574867880211391,1,0.0
antidote,0,0,2,0.015208455666470933,2,1.0
thon,0,0,1,0.007574867880211391,1,0.0
cannier,0,0,1,0.007574867880211391,1,0.0
weep,1,0,1,-0.0001174398120963021,2,1.0
respected,1,0,0,-0.007751027598355844,1,0.0
foremostthe,0,0,1,0.007574867880211391,1,0.0
hennings,0,0,1,0.007574867880211391,1,0.0
swims,1,0,1,-0.0001174398120963021,2,1.0
sleeper,2,0,2,-0.00017615971814445228,4,2.0
grade,5,0,2,-0.02325308279506753,7,2.807354922057604
physicality,0,0,1,0.007574867880211391,1,0.0
boards,1,0,1,-0.0001174398120963021,2,1.0
sand,0,0,1,0.007574867880211391,1,0.0
swear,1,0,1,-0.0001174398120963021,2,1.0
convincing,1,0,5,0.030416911332941866,6,2.584962500721156
creeping,0,0,2,0.015208455666470933,2,1.0
stitched,1,0,0,-0.007751027598355844,1,0.0
tides,1,0,0,-0.007751027598355844,1,0.0
grouper,1,0,0,-0.007751027598355844,1,0.0
gasping,1,0,1,-0.0001174398120963021,2,1.0
melodrama,11,0,3,-0.06177334116265415,14,3.8073549220576037
beached,1,0,0,-0.007751027598355844,1,0.0
radar,2,0,2,-0.00017615971814445228,4,2.0
crappola,0,0,1,0.007574867880211391,1,0.0
operating,0,0,1,0.007574867880211391,1,0.0
stewart,0,0,2,0.015208455666470933,2,1.0
entry,2,0,4,0.015091015854374633,6,2.584962500721156
wherever,0,0,1,0.007574867880211391,1,0.0
core,8,0,5,-0.023429242513211983,13,3.700439718141092
summertime,1,0,2,0.0075161479741632405,3,1.5849625007211563
sounds,3,0,4,0.00739870816206694,7,2.807354922057604
enveloping,0,0,1,0.007574867880211391,1,0.0
cresting,1,0,0,-0.007751027598355844,1,0.0
fillers,1,0,0,-0.007751027598355844,1,0.0
storylines,1,0,0,-0.007751027598355844,1,0.0
horrible,5,0,0,-0.038520258367586616,5,2.321928094887362
bitchin,0,0,1,0.007574867880211391,1,0.0
bikini,0,0,1,0.007574867880211391,1,0.0
ankle,0,0,1,0.007574867880211391,1,0.0
babes,0,0,2,0.015208455666470933,2,1.0
prolonged,1,0,0,-0.007751027598355844,1,0.0
barn,1,0,1,-0.0001174398120963021,2,1.0
burningly,1,0,0,-0.007751027598355844,1,0.0
favor,3,0,1,-0.015502055196711688,4,2.0
emphasis,3,0,0,-0.02313564298297123,3,1.5849625007211563
shifted,1,0,0,-0.007751027598355844,1,0.0
waterlogged,3,0,0,-0.02313564298297123,3,1.5849625007211563
posters,0,0,1,0.007574867880211391,1,0.0
bikinis,0,0,1,0.007574867880211391,1,0.0
bosworth,0,0,1,0.007574867880211391,1,0.0
surfboards,0,0,1,0.007574867880211391,1,0.0
dazzling,1,0,6,0.03805049911920141,7,2.807354922057604
form,2,0,6,0.030358191426893714,8,3.0
thrillingly,0,0,1,0.007574867880211391,1,0.0
stoked,0,0,1,0.007574867880211391,1,0.0
schmaltz,2,0,0,-0.015443335290663537,2,1.0
empowering,1,0,0,-0.007751027598355844,1,0.0
afterthought,1,0,1,-0.0001174398120963021,2,1.0
creaky,2,0,0,-0.015443335290663537,2,1.0
conditioning,1,0,1,-0.0001174398120963021,2,1.0
dazzled,0,0,1,0.007574867880211391,1,0.0
noticed,1,0,1,-0.0001174398120963021,2,1.0
incurious,0,0,1,0.007574867880211391,1,0.0
gadfly,0,0,1,0.007574867880211391,1,0.0
perfected,0,0,1,0.007574867880211391,1,0.0
aggrandizing,0,0,1,0.007574867880211391,1,0.0
potent,0,0,3,0.022842043452730474,3,1.5849625007211563
politically,0,0,1,0.007574867880211391,1,0.0
politics,3,0,7,0.030299471520845563,10,3.3219280948873626
understandable,0,0,2,0.015208455666470933,2,1.0
tiros,0,0,1,0.007574867880211391,1,0.0
como,1,0,2,0.0075161479741632405,3,1.5849625007211563
columbine,0,0,9,0.06864357017028773,9,3.1699250014423126
trocadilho,0,0,1,0.007574867880211391,1,0.0
negar,0,0,1,0.007574867880211391,1,0.0
não,3,0,2,-0.007868467410452145,5,2.321928094887362
brilhantismo,0,0,1,0.007574867880211391,1,0.0
seu,0,0,1,0.007574867880211391,1,0.0
há,0,0,1,0.007574867880211391,1,0.0
alvo,0,0,1,0.007574867880211391,1,0.0
perdão,0,0,1,0.007574867880211391,1,0.0
quando,0,0,1,0.007574867880211391,1,0.0
argumentação,0,0,1,0.007574867880211391,1,0.0
acerta,0,0,1,0.007574867880211391,1,0.0
diretor,1,0,1,-0.0001174398120963021,2,1.0
suggest,1,0,4,0.022783323546682326,5,2.321928094887362
darkest,0,0,1,0.007574867880211391,1,0.0
sheds,0,0,2,0.015208455666470933,2,1.0
torch,0,0,1,0.007574867880211391,1,0.0
bespectacled,0,0,1,0.007574867880211391,1,0.0
underpaid,0,0,1,0.007574867880211391,1,0.0
shuffling,0,0,1,0.007574867880211391,1,0.0
jeans,0,0,1,0.007574867880211391,1,0.0
baggy,1,0,1,-0.0001174398120963021,2,1.0
bowling,0,0,8,0.06100998238402819,8,3.0
disquieting,0,0,1,0.007574867880211391,1,0.0
solutions,0,0,3,0.022842043452730474,3,1.5849625007211563
reactions,0,0,1,0.007574867880211391,1,0.0
steering,0,0,1,0.007574867880211391,1,0.0
jerk,1,0,1,-0.0001174398120963021,2,1.0
knee,1,0,1,-0.0001174398120963021,2,1.0
genius,1,0,1,-0.0001174398120963021,2,1.0
incendiary,0,0,1,0.007574867880211391,1,0.0
polemiclove,0,0,1,0.007574867880211391,1,0.0
convictions,1,0,3,0.015149735760422781,4,2.0
admirethe,0,0,1,0.007574867880211391,1,0.0
objective,1,0,3,0.015149735760422781,4,2.0
loathe,0,0,1,0.007574867880211391,1,0.0
applaud,0,0,3,0.022842043452730474,3,1.5849625007211563
debate,0,0,3,0.022842043452730474,3,1.5849625007211563
walking,1,0,3,0.015149735760422781,4,2.0
camps,1,0,1,-0.0001174398120963021,2,1.0
encourage,0,0,2,0.015208455666470933,2,1.0
halfway,4,0,1,-0.023194362889019382,5,2.321928094887362
brim,1,0,1,-0.0001174398120963021,2,1.0
rambling,0,0,1,0.007574867880211391,1,0.0
instigator,0,0,1,0.007574867880211391,1,0.0
crucifixion,0,0,1,0.007574867880211391,1,0.0
juxtaposition,0,0,1,0.007574867880211391,1,0.0
operandi,0,0,1,0.007574867880211391,1,0.0
modus,0,0,1,0.007574867880211391,1,0.0
veneer,0,0,2,0.015208455666470933,2,1.0
strength,1,0,5,0.030416911332941866,6,2.584962500721156
paints,1,0,2,0.0075161479741632405,3,1.5849625007211563
soaked,1,0,1,-0.0001174398120963021,2,1.0
theaters,4,0,4,-0.00029359953024075264,8,3.0
veins,0,0,1,0.007574867880211391,1,0.0
unindicted,0,0,1,0.007574867880211391,1,0.0
zeal,1,0,3,0.015149735760422781,4,2.0
asking,0,0,3,0.022842043452730474,3,1.5849625007211563
root,1,0,3,0.015149735760422781,4,2.0
valuable,1,0,4,0.022783323546682326,5,2.321928094887362
journalist,0,0,1,0.007574867880211391,1,0.0
requirements,0,0,1,0.007574867880211391,1,0.0
afflict,0,0,1,0.007574867880211391,1,0.0
fulfils,0,0,2,0.015208455666470933,2,1.0
afflicted,0,0,1,0.007574867880211391,1,0.0
china,0,0,1,0.007574867880211391,1,0.0
liberalism,0,0,1,0.007574867880211391,1,0.0
provocateur,0,0,1,0.007574867880211391,1,0.0
bull,3,0,2,-0.007868467410452145,5,2.321928094887362
progressive,0,0,1,0.007574867880211391,1,0.0
groups,1,0,1,-0.0001174398120963021,2,1.0
slaps,0,0,1,0.007574867880211391,1,0.0
glib,1,0,2,0.0075161479741632405,3,1.5849625007211563
fudges,1,0,0,-0.007751027598355844,1,0.0
engages,1,0,2,0.0075161479741632405,3,1.5849625007211563
satirical,3,0,3,-0.0002348796241926042,6,2.584962500721156
journalism,1,0,1,-0.0001174398120963021,2,1.0
facile,2,0,1,-0.007809747504403995,3,1.5849625007211563
swift,0,0,1,0.007574867880211391,1,0.0
service,1,0,4,0.022783323546682326,5,2.321928094887362
remaining,1,0,1,-0.0001174398120963021,2,1.0
invaluable,0,0,1,0.007574867880211391,1,0.0
critics,3,0,4,0.00739870816206694,7,2.807354922057604
encouraging,1,0,2,0.0075161479741632405,3,1.5849625007211563
sparking,0,0,1,0.007574867880211391,1,0.0
savagely,0,0,1,0.007574867880211391,1,0.0
provoke,1,0,2,0.0075161479741632405,3,1.5849625007211563
stimulating,0,0,4,0.03047563123899002,4,2.0
unnerving,1,0,5,0.030416911332941866,6,2.584962500721156
scratches,0,0,1,0.007574867880211391,1,0.0
itch,0,0,1,0.007574867880211391,1,0.0
fingering,0,0,1,0.007574867880211391,1,0.0
mull,0,0,2,0.015208455666470933,2,1.0
outright,0,0,2,0.015208455666470933,2,1.0
coaxes,0,0,1,0.007574867880211391,1,0.0
energizing,0,0,1,0.007574867880211391,1,0.0
imperfectly,0,0,1,0.007574867880211391,1,0.0
scary,10,0,11,0.006987668819729884,21,4.392317422778761
obsession,1,0,1,-0.0001174398120963021,2,1.0
volcanically,0,0,1,0.007574867880211391,1,0.0
meant,2,0,3,0.0074574280681150885,5,2.321928094887362
thoughtfulness,1,0,1,-0.0001174398120963021,2,1.0
ferocity,1,0,1,-0.0001174398120963021,2,1.0
debated,0,0,1,0.007574867880211391,1,0.0
appropriate,4,0,1,-0.023194362889019382,5,2.321928094887362
widely,0,0,1,0.007574867880211391,1,0.0
shticks,0,0,1,0.007574867880211391,1,0.0
noisy,2,0,1,-0.007809747504403995,3,1.5849625007211563
consciousness,1,0,3,0.015149735760422781,4,2.0
royally,0,0,1,0.007574867880211391,1,0.0
searching,3,0,1,-0.015502055196711688,4,2.0
sick,3,0,3,-0.0002348796241926042,6,2.584962500721156
rekindles,0,0,1,0.007574867880211391,1,0.0
muckraking,0,0,1,0.007574867880211391,1,0.0
1960s,0,0,1,0.007574867880211391,1,0.0
thirst,0,0,1,0.007574867880211391,1,0.0
understands,1,0,5,0.030416911332941866,6,2.584962500721156
disposition,0,0,1,0.007574867880211391,1,0.0
sunny,0,0,3,0.022842043452730474,3,1.5849625007211563
dimensional,2,0,5,0.022724603640634174,7,2.807354922057604
digest,0,0,2,0.015208455666470933,2,1.0
easier,5,0,1,-0.030886670581327075,6,2.584962500721156
exhibit,1,0,1,-0.0001174398120963021,2,1.0
hackneyed,8,0,3,-0.03869641808573107,11,3.4594316186372978
brown,3,0,7,0.030299471520845563,10,3.3219280948873626
sugar,7,0,11,0.030064591896652962,18,4.169925001442312
articulate,1,0,1,-0.0001174398120963021,2,1.0
signals,1,0,2,0.0075161479741632405,3,1.5849625007211563
famuyiwa,0,0,2,0.015208455666470933,2,1.0
ups,5,0,3,-0.01561949500880799,8,3.0
obligatory,4,0,0,-0.030827950675278923,4,2.0
haven,4,0,5,0.007339988256018788,9,3.1699250014423126
scuttled,1,0,0,-0.007751027598355844,1,0.0
regard,2,0,0,-0.015443335290663537,2,1.0
boilerplate,2,0,0,-0.015443335290663537,2,1.0
asleep,1,0,0,-0.007751027598355844,1,0.0
liven,2,0,0,-0.015443335290663537,2,1.0
sorely,3,0,0,-0.02313564298297123,3,1.5849625007211563
guarantee,2,0,1,-0.007809747504403995,3,1.5849625007211563
metaphor,0,0,2,0.015208455666470933,2,1.0
boogaloo,1,0,0,-0.007751027598355844,1,0.0
yo,1,0,0,-0.007751027598355844,1,0.0
electric,2,0,1,-0.007809747504403995,3,1.5849625007211563
blandness,3,0,0,-0.02313564298297123,3,1.5849625007211563
calculations,1,0,0,-0.007751027598355844,1,0.0
curse,1,0,1,-0.0001174398120963021,2,1.0
admirably,0,0,2,0.015208455666470933,2,1.0
weaving,0,0,1,0.007574867880211391,1,0.0
aspires,1,0,1,-0.0001174398120963021,2,1.0
rapport,0,0,2,0.015208455666470933,2,1.0
exceptionally,0,0,4,0.03047563123899002,4,2.0
cheery,1,0,2,0.0075161479741632405,3,1.5849625007211563
relaxing,0,0,1,0.007574867880211391,1,0.0
cozy,0,0,1,0.007574867880211391,1,0.0
manner,3,0,7,0.030299471520845563,10,3.3219280948873626
contrivance,0,0,2,0.015208455666470933,2,1.0
genre,13,0,20,0.05261303581914267,33,5.044394119358453
tasteful,1,0,2,0.0075161479741632405,3,1.5849625007211563
forcing,1,0,1,-0.0001174398120963021,2,1.0
conceal,0,0,1,0.007574867880211391,1,0.0
harder,2,0,1,-0.007809747504403995,3,1.5849625007211563
wish,6,0,3,-0.023311802701115682,9,3.1699250014423126
contrivances,1,0,5,0.030416911332941866,6,2.584962500721156
goals,1,0,2,0.0075161479741632405,3,1.5849625007211563
decisions,0,0,1,0.007574867880211391,1,0.0
arcana,1,0,0,-0.007751027598355844,1,0.0
rap,7,0,0,-0.053904873752202,7,2.807354922057604
savviest,1,0,0,-0.007751027598355844,1,0.0
referencing,1,0,0,-0.007751027598355844,1,0.0
alienate,2,0,1,-0.007809747504403995,3,1.5849625007211563
hear,4,0,2,-0.015560775102759838,6,2.584962500721156
records,1,0,0,-0.007751027598355844,1,0.0
etc,2,0,0,-0.015443335290663537,2,1.0
revels,1,0,0,-0.007751027598355844,1,0.0
apartments,1,0,0,-0.007751027598355844,1,0.0
unintentionally,6,0,0,-0.04621256605989431,6,2.584962500721156
pornographic,1,0,0,-0.007751027598355844,1,0.0
drumbeat,1,0,0,-0.007751027598355844,1,0.0
authenticity,2,0,0,-0.015443335290663537,2,1.0
hoops,0,0,1,0.007574867880211391,1,0.0
summons,1,0,0,-0.007751027598355844,1,0.0
cloying,2,0,1,-0.007809747504403995,3,1.5849625007211563
quadrangle,1,0,0,-0.007751027598355844,1,0.0
easygoing,0,0,1,0.007574867880211391,1,0.0
appreciate,2,0,7,0.037991779213153255,9,3.1699250014423126
kissy,0,0,1,0.007574867880211391,1,0.0
sincerity,0,0,2,0.015208455666470933,2,1.0
watered,2,0,1,-0.007809747504403995,3,1.5849625007211563
criticizes,1,0,0,-0.007751027598355844,1,0.0
industry,2,0,6,0.030358191426893714,8,3.0
lawrence,12,0,6,-0.04656488549618321,18,4.169925001442312
martin,5,0,5,-0.00035231943628890455,10,3.3219280948873626
obnoxiously,0,0,1,0.007574867880211391,1,0.0
explode,0,0,1,0.007574867880211391,1,0.0
screens,0,0,3,0.022842043452730474,3,1.5849625007211563
shelf,4,0,2,-0.015560775102759838,6,2.584962500721156
languishing,0,0,1,0.007574867880211391,1,0.0
irritates,0,0,1,0.007574867880211391,1,0.0
saddens,0,0,1,0.007574867880211391,1,0.0
deserve,4,0,1,-0.023194362889019382,5,2.321928094887362
*,6,0,8,0.014856136230182032,14,3.8073549220576037
undead,0,0,1,0.007574867880211391,1,0.0
regret,1,0,1,-0.0001174398120963021,2,1.0
atmospherics,0,0,1,0.007574867880211391,1,0.0
combines,0,0,3,0.022842043452730474,3,1.5849625007211563
zinger,1,0,1,-0.0001174398120963021,2,1.0
crowd,6,0,8,0.014856136230182032,14,3.8073549220576037
pleaser,1,0,7,0.04568408690546095,8,3.0
minded,3,0,6,0.022665883734586022,9,3.1699250014423126
schlepping,0,0,1,0.007574867880211391,1,0.0
ashtray,0,0,1,0.007574867880211391,1,0.0
maker,1,0,4,0.022783323546682326,5,2.321928094887362
indiana,0,0,1,0.007574867880211391,1,0.0
misplaced,1,0,1,-0.0001174398120963021,2,1.0
globe,0,0,1,0.007574867880211391,1,0.0
fingers,0,0,2,0.015208455666470933,2,1.0
snap,1,0,1,-0.0001174398120963021,2,1.0
sinatra,0,0,1,0.007574867880211391,1,0.0
grinning,1,0,1,-0.0001174398120963021,2,1.0
sobre,0,0,3,0.022842043452730474,3,1.5849625007211563
personagens,0,0,2,0.015208455666470933,2,1.0
interações,0,0,1,0.007574867880211391,1,0.0
apenas,1,0,1,-0.0001174398120963021,2,1.0
um,6,0,4,-0.015678214914856138,10,3.3219280948873626
curiosa,0,0,1,0.007574867880211391,1,0.0
mas,2,0,2,-0.00017615971814445228,4,2.0
seus,0,0,1,0.007574867880211391,1,0.0
torna,0,0,1,0.007574867880211391,1,0.0
uma,1,0,4,0.022783323546682326,5,2.321928094887362
perseguição,0,0,1,0.007574867880211391,1,0.0
às,0,0,1,0.007574867880211391,1,0.0
belo,1,0,1,-0.0001174398120963021,2,1.0
divertida,0,0,4,0.03047563123899002,4,2.0
história,0,0,1,0.007574867880211391,1,0.0
entre,0,0,1,0.007574867880211391,1,0.0
graças,0,0,1,0.007574867880211391,1,0.0
estudo,0,0,1,0.007574867880211391,1,0.0
dicaprio,0,0,3,0.022842043452730474,3,1.5849625007211563
zings,0,0,2,0.015208455666470933,2,1.0
pathos,0,0,5,0.03810921902524956,5,2.321928094887362
enjoying,2,0,3,0.0074574280681150885,5,2.321928094887362
immensely,0,0,3,0.022842043452730474,3,1.5849625007211563
impersonation,0,0,1,0.007574867880211391,1,0.0
smoothly,1,0,3,0.015149735760422781,4,2.0
definite,0,0,2,0.015208455666470933,2,1.0
delight,2,0,8,0.0456253669994128,10,3.3219280948873626
weaknesses,1,0,1,-0.0001174398120963021,2,1.0
escapism,3,0,3,-0.0002348796241926042,6,2.584962500721156
sixties,0,0,2,0.015208455666470933,2,1.0
slickness,0,0,1,0.007574867880211391,1,0.0
bouncy,1,0,4,0.022783323546682326,5,2.321928094887362
establishing,0,0,1,0.007574867880211391,1,0.0
insistence,0,0,2,0.015208455666470933,2,1.0
abagnale,0,0,1,0.007574867880211391,1,0.0
motivation,1,0,1,-0.0001174398120963021,2,1.0
missteps,0,0,2,0.015208455666470933,2,1.0
recharged,0,0,1,0.007574867880211391,1,0.0
lightest,0,0,1,0.007574867880211391,1,0.0
induced,0,0,1,0.007574867880211391,1,0.0
masses,0,0,2,0.015208455666470933,2,1.0
sentimental,2,0,4,0.015091015854374633,6,2.584962500721156
hype,2,0,2,-0.00017615971814445228,4,2.0
glitz,0,0,1,0.007574867880211391,1,0.0
reminder,0,0,3,0.022842043452730474,3,1.5849625007211563
coaster,0,0,2,0.015208455666470933,2,1.0
roller,0,0,2,0.015208455666470933,2,1.0
leo,0,0,1,0.007574867880211391,1,0.0
vulnerability,1,0,1,-0.0001174398120963021,2,1.0
larcenous,0,0,1,0.007574867880211391,1,0.0
oozes,1,0,2,0.0075161479741632405,3,1.5849625007211563
martini,0,0,1,0.007574867880211391,1,0.0
leonardo,0,0,1,0.007574867880211391,1,0.0
belong,0,0,1,0.007574867880211391,1,0.0
splendid,0,0,4,0.03047563123899002,4,2.0
larky,0,0,1,0.007574867880211391,1,0.0
conned,0,0,1,0.007574867880211391,1,0.0
endeavor,2,0,1,-0.007809747504403995,3,1.5849625007211563
merrily,0,0,1,0.007574867880211391,1,0.0
yourselves,0,0,1,0.007574867880211391,1,0.0
shining,1,0,1,-0.0001174398120963021,2,1.0
technically,1,0,1,-0.0001174398120963021,2,1.0
utilizing,0,0,1,0.007574867880211391,1,0.0
superb,1,0,5,0.030416911332941866,6,2.584962500721156
talents,6,0,5,-0.008044627128596597,11,3.4594316186372978
flair,2,0,8,0.0456253669994128,10,3.3219280948873626
expertly,1,0,2,0.0075161479741632405,3,1.5849625007211563
brightly,1,0,1,-0.0001174398120963021,2,1.0
bogged,3,0,0,-0.02313564298297123,3,1.5849625007211563
140,1,0,0,-0.007751027598355844,1,0.0
badly,9,0,0,-0.06928948913681739,9,3.1699250014423126
leaks,1,0,1,-0.0001174398120963021,2,1.0
ranks,0,0,3,0.022842043452730474,3,1.5849625007211563
affirms,0,0,1,0.007574867880211391,1,0.0
gifts,0,0,3,0.022842043452730474,3,1.5849625007211563
offerings,0,0,3,0.022842043452730474,3,1.5849625007211563
masterpieces,0,0,1,0.007574867880211391,1,0.0
deceptively,0,0,4,0.03047563123899002,4,2.0
slight,5,0,6,0.007281268349970636,11,3.4594316186372978
overmanipulative,0,0,1,0.007574867880211391,1,0.0
practices,0,0,1,0.007574867880211391,1,0.0
unconned,0,0,1,0.007574867880211391,1,0.0
adventurous,1,0,1,-0.0001174398120963021,2,1.0
gently,0,0,1,0.007574867880211391,1,0.0
sweetly,0,0,2,0.015208455666470933,2,1.0
rarities,0,0,1,0.007574867880211391,1,0.0
rarity,0,0,3,0.022842043452730474,3,1.5849625007211563
soulful,0,0,2,0.015208455666470933,2,1.0
fashions,0,0,1,0.007574867880211391,1,0.0
trends,0,0,1,0.007574867880211391,1,0.0
background,0,0,2,0.015208455666470933,2,1.0
pink,2,0,1,-0.007809747504403995,3,1.5849625007211563
panther,0,0,1,0.007574867880211391,1,0.0
received,0,0,2,0.015208455666470933,2,1.0
lanes,0,0,6,0.0457428068115091,6,2.584962500721156
gratefully,0,0,2,0.015208455666470933,2,1.0
infuriating,1,0,2,0.0075161479741632405,3,1.5849625007211563
cheated,1,0,1,-0.0001174398120963021,2,1.0
pandered,1,0,0,-0.007751027598355844,1,0.0
anomaly,0,0,1,0.007574867880211391,1,0.0
cuss,1,0,0,-0.007751027598355844,1,0.0
mounts,0,0,1,0.007574867880211391,1,0.0
cheek,0,0,5,0.03810921902524956,5,2.321928094887362
sparring,0,0,1,0.007574867880211391,1,0.0
persuasion,1,0,0,-0.007751027598355844,1,0.0
artsy,2,0,2,-0.00017615971814445228,4,2.0
warring,0,0,1,0.007574867880211391,1,0.0
plausible,0,0,2,0.015208455666470933,2,1.0
profile,1,0,5,0.030416911332941866,6,2.584962500721156
passable,5,0,0,-0.038520258367586616,5,2.321928094887362
underneath,0,0,1,0.007574867880211391,1,0.0
rug,1,0,2,0.0075161479741632405,3,1.5849625007211563
plunging,0,0,1,0.007574867880211391,1,0.0
timeliness,0,0,1,0.007574867880211391,1,0.0
flawless,0,0,2,0.015208455666470933,2,1.0
discourage,0,0,1,0.007574867880211391,1,0.0
actively,0,0,1,0.007574867880211391,1,0.0
food,2,0,1,-0.007809747504403995,3,1.5849625007211563
classify,0,0,1,0.007574867880211391,1,0.0
absorbing,0,0,5,0.03810921902524956,5,2.321928094887362
taut,1,0,2,0.0075161479741632405,3,1.5849625007211563
dilemmas,0,0,1,0.007574867880211391,1,0.0
fallibility,0,0,1,0.007574867880211391,1,0.0
bothers,1,0,1,-0.0001174398120963021,2,1.0
multiplex,1,0,2,0.0075161479741632405,3,1.5849625007211563
accustomed,0,0,1,0.007574867880211391,1,0.0
pomposity,2,0,0,-0.015443335290663537,2,1.0
navigates,1,0,0,-0.007751027598355844,1,0.0
pretentiousness,1,0,0,-0.007751027598355844,1,0.0
fade,3,0,0,-0.02313564298297123,3,1.5849625007211563
tougher,1,0,1,-0.0001174398120963021,2,1.0
tock,1,0,0,-0.007751027598355844,1,0.0
tick,1,0,0,-0.007751027598355844,1,0.0
yelling,1,0,0,-0.007751027598355844,1,0.0
fare,4,0,7,0.02260716382853787,11,3.4594316186372978
finesse,0,0,3,0.022842043452730474,3,1.5849625007211563
lightweight,1,0,4,0.022783323546682326,5,2.321928094887362
mitchell,0,0,1,0.007574867880211391,1,0.0
relatively,4,0,2,-0.015560775102759838,6,2.584962500721156
thematic,1,0,3,0.015149735760422781,4,2.0
handily,0,0,1,0.007574867880211391,1,0.0
heft,0,0,2,0.015208455666470933,2,1.0
heck,0,0,1,0.007574867880211391,1,0.0
reversals,0,0,1,0.007574867880211391,1,0.0
sinner,0,0,1,0.007574867880211391,1,0.0
relentless,3,0,1,-0.015502055196711688,4,2.0
teasing,0,0,1,0.007574867880211391,1,0.0
shaped,0,0,3,0.022842043452730474,3,1.5849625007211563
symmetrical,0,0,1,0.007574867880211391,1,0.0
pray,0,0,1,0.007574867880211391,1,0.0
deed,0,0,2,0.015208455666470933,2,1.0
sympathize,0,0,1,0.007574867880211391,1,0.0
pulls,2,0,6,0.030358191426893714,8,3.0
hate,6,0,6,-0.00041103934233705647,12,3.5849625007211565
unmannerliness,0,0,1,0.007574867880211391,1,0.0
seething,0,0,1,0.007574867880211391,1,0.0
searing,0,0,2,0.015208455666470933,2,1.0
insight,6,0,5,-0.008044627128596597,11,3.4594316186372978
gluing,0,0,1,0.007574867880211391,1,0.0
preachiness,0,0,2,0.015208455666470933,2,1.0
intermittent,1,0,1,-0.0001174398120963021,2,1.0
dampened,0,0,1,0.007574867880211391,1,0.0
unconvincingly,0,0,1,0.007574867880211391,1,0.0
slickly,1,0,1,-0.0001174398120963021,2,1.0
boldface,1,0,0,-0.007751027598355844,1,0.0
profanities,1,0,0,-0.007751027598355844,1,0.0
platitudes,1,0,1,-0.0001174398120963021,2,1.0
macgraw,1,0,0,-0.007751027598355844,1,0.0
cleanflicks,1,0,0,-0.007751027598355844,1,0.0
competence,0,0,1,0.007574867880211391,1,0.0
junctures,1,0,0,-0.007751027598355844,1,0.0
paint,5,0,3,-0.01561949500880799,8,3.0
implications,1,0,0,-0.007751027598355844,1,0.0
square,1,0,0,-0.007751027598355844,1,0.0
ironic,1,0,2,0.0075161479741632405,3,1.5849625007211563
amateurishly,2,0,0,-0.015443335290663537,2,1.0
imitative,1,0,0,-0.007751027598355844,1,0.0
innumerable,1,0,0,-0.007751027598355844,1,0.0
derisions,1,0,0,-0.007751027598355844,1,0.0
religious,1,0,0,-0.007751027598355844,1,0.0
bailiwick,1,0,0,-0.007751027598355844,1,0.0
imaginative,4,0,8,0.030240751614797418,12,3.5849625007211565
tonal,1,0,2,0.0075161479741632405,3,1.5849625007211563
quirks,0,0,4,0.03047563123899002,4,2.0
forgive,2,0,3,0.0074574280681150885,5,2.321928094887362
oodles,0,0,1,0.007574867880211391,1,0.0
mischievous,0,0,1,0.007574867880211391,1,0.0
extraordinarily,1,0,0,-0.007751027598355844,1,0.0
tunney,1,0,2,0.0075161479741632405,3,1.5849625007211563
misfire,3,0,0,-0.02313564298297123,3,1.5849625007211563
peculiar,1,0,2,0.0075161479741632405,3,1.5849625007211563
dud,5,0,0,-0.038520258367586616,5,2.321928094887362
putting,0,0,2,0.015208455666470933,2,1.0
heroine,3,0,4,0.00739870816206694,7,2.807354922057604
engrossed,0,0,2,0.015208455666470933,2,1.0
allowed,0,0,2,0.015208455666470933,2,1.0
hybrid,6,0,3,-0.023311802701115682,9,3.1699250014423126
harm,3,0,0,-0.02313564298297123,3,1.5849625007211563
empowerment,3,0,3,-0.0002348796241926042,6,2.584962500721156
glue,1,0,0,-0.007751027598355844,1,0.0
whimsical,1,0,1,-0.0001174398120963021,2,1.0
imprisonment,1,0,0,-0.007751027598355844,1,0.0
hang,2,0,2,-0.00017615971814445228,4,2.0
whimsy,0,0,2,0.015208455666470933,2,1.0
subtext,0,0,2,0.015208455666470933,2,1.0
lite,1,0,4,0.022783323546682326,5,2.321928094887362
armed,0,0,2,0.015208455666470933,2,1.0
indie,3,0,5,0.015032295948326481,8,3.0
liz,0,0,1,0.007574867880211391,1,0.0
rad,0,0,1,0.007574867880211391,1,0.0
rocker,0,0,1,0.007574867880211391,1,0.0
phair,0,0,1,0.007574867880211391,1,0.0
peek,0,0,1,0.007574867880211391,1,0.0
doorstep,1,0,1,-0.0001174398120963021,2,1.0
unconvincing,3,0,0,-0.02313564298297123,3,1.5849625007211563
lags,1,0,0,-0.007751027598355844,1,0.0
reminiscent,2,0,2,-0.00017615971814445228,4,2.0
dramatics,2,0,0,-0.015443335290663537,2,1.0
lurches,1,0,1,-0.0001174398120963021,2,1.0
strongly,5,0,0,-0.038520258367586616,5,2.321928094887362
aimless,1,0,0,-0.007751027598355844,1,0.0
wake,2,0,1,-0.007809747504403995,3,1.5849625007211563
beat,5,0,5,-0.00035231943628890455,10,3.3219280948873626
captivatingly,0,0,1,0.007574867880211391,1,0.0
entire,13,0,5,-0.061890780974750446,18,4.169925001442312
eccentric,2,0,3,0.0074574280681150885,5,2.321928094887362
dopey,2,0,1,-0.007809747504403995,3,1.5849625007211563
clothed,1,0,0,-0.007751027598355844,1,0.0
hipness,2,0,0,-0.015443335290663537,2,1.0
layers,2,0,0,-0.015443335290663537,2,1.0
disarming,0,0,2,0.015208455666470933,2,1.0
wonderland,0,0,1,0.007574867880211391,1,0.0
disoriented,0,0,1,0.007574867880211391,1,0.0
stalker,1,0,1,-0.0001174398120963021,2,1.0
condensed,0,0,3,0.022842043452730474,3,1.5849625007211563
brimming,0,0,2,0.015208455666470933,2,1.0
coltish,0,0,1,0.007574867880211391,1,0.0
stalking,1,0,1,-0.0001174398120963021,2,1.0
grasps,1,0,0,-0.007751027598355844,1,0.0
unlikable,5,0,0,-0.038520258367586616,5,2.321928094887362
endearingly,0,0,1,0.007574867880211391,1,0.0
gimmick,0,0,1,0.007574867880211391,1,0.0
cute,7,0,11,0.030064591896652962,18,4.169925001442312
pale,2,0,1,-0.007809747504403995,3,1.5849625007211563
adequate,2,0,1,-0.007809747504403995,3,1.5849625007211563
rousing,1,0,3,0.015149735760422781,4,2.0
musical,2,0,8,0.0456253669994128,10,3.3219280948873626
naughty,2,0,3,0.0074574280681150885,5,2.321928094887362
frictionless,0,0,1,0.007574867880211391,1,0.0
smoother,0,0,1,0.007574867880211391,1,0.0
flashy,3,0,1,-0.015502055196711688,4,2.0
torn,1,0,0,-0.007751027598355844,1,0.0
dingoes,1,0,0,-0.007751027598355844,1,0.0
betrayals,0,0,1,0.007574867880211391,1,0.0
celebrated,0,0,2,0.015208455666470933,2,1.0
currency,1,0,1,-0.0001174398120963021,2,1.0
backstabbing,0,0,1,0.007574867880211391,1,0.0
zellweger,0,0,4,0.03047563123899002,4,2.0
diamonds,0,0,1,0.007574867880211391,1,0.0
glorifying,0,0,1,0.007574867880211391,1,0.0
polished,0,0,6,0.0457428068115091,6,2.584962500721156
amazed,0,0,1,0.007574867880211391,1,0.0
silk,0,0,1,0.007574867880211391,1,0.0
crossing,0,0,2,0.015208455666470933,2,1.0
sheathed,0,0,1,0.007574867880211391,1,0.0
wondering,2,0,0,-0.015443335290663537,2,1.0
hoofing,0,0,1,0.007574867880211391,1,0.0
gere,0,0,6,0.0457428068115091,6,2.584962500721156
crooning,0,0,1,0.007574867880211391,1,0.0
infiltrated,0,0,1,0.007574867880211391,1,0.0
blaring,1,0,1,-0.0001174398120963021,2,1.0
flashbulbs,0,0,1,0.007574867880211391,1,0.0
sequins,0,0,1,0.007574867880211391,1,0.0
stabbing,1,0,1,-0.0001174398120963021,2,1.0
flaunting,0,0,1,0.007574867880211391,1,0.0
seemed,2,0,2,-0.00017615971814445228,4,2.0
goodness,0,0,1,0.007574867880211391,1,0.0
pizzazz,0,0,1,0.007574867880211391,1,0.0
rhythm,3,0,2,-0.007868467410452145,5,2.321928094887362
confidence,0,0,2,0.015208455666470933,2,1.0
properly,1,0,2,0.0075161479741632405,3,1.5849625007211563
burst,0,0,1,0.007574867880211391,1,0.0
na,2,0,1,-0.007809747504403995,3,1.5849625007211563
evolução,0,0,1,0.007574867880211391,1,0.0
cativante,0,0,1,0.007574867880211391,1,0.0
direção,1,0,1,-0.0001174398120963021,2,1.0
é,4,0,3,-0.007927187316500297,7,2.807354922057604
passo,0,0,1,0.007574867880211391,1,0.0
contrária,0,0,1,0.007574867880211391,1,0.0
musicais,0,0,1,0.007574867880211391,1,0.0
divertido,0,0,1,0.007574867880211391,1,0.0
representando,0,0,1,0.007574867880211391,1,0.0
à,0,0,1,0.007574867880211391,1,0.0
vai,0,0,1,0.007574867880211391,1,0.0
acaba,1,0,1,-0.0001174398120963021,2,1.0
dos,0,0,1,0.007574867880211391,1,0.0
ser,0,0,1,0.007574867880211391,1,0.0
até,0,0,1,0.007574867880211391,1,0.0
pode,0,0,1,0.007574867880211391,1,0.0
c,2,0,1,-0.007809747504403995,3,1.5849625007211563
singin,0,0,1,0.007574867880211391,1,0.0
aisles,0,0,3,0.022842043452730474,3,1.5849625007211563
dancin,0,0,1,0.007574867880211391,1,0.0
ol,1,0,2,0.0075161479741632405,3,1.5849625007211563
zeta,0,0,2,0.015208455666470933,2,1.0
reilly,0,0,2,0.015208455666470933,2,1.0
renée,0,0,1,0.007574867880211391,1,0.0
replete,2,0,2,-0.00017615971814445228,4,2.0
glorifies,0,0,1,0.007574867880211391,1,0.0
unsunny,0,0,1,0.007574867880211391,1,0.0
glamorizes,0,0,1,0.007574867880211391,1,0.0
steak,0,0,1,0.007574867880211391,1,0.0
sizzle,0,0,2,0.015208455666470933,2,1.0
incarnation,0,0,1,0.007574867880211391,1,0.0
fizz,2,0,1,-0.007809747504403995,3,1.5849625007211563
infectious,0,0,3,0.022842043452730474,3,1.5849625007211563
finale,3,0,3,-0.0002348796241926042,6,2.584962500721156
courtroom,3,0,3,-0.0002348796241926042,6,2.584962500721156
circus,0,0,2,0.015208455666470933,2,1.0
burnt,0,0,1,0.007574867880211391,1,0.0
mirrors,0,0,1,0.007574867880211391,1,0.0
damsels,0,0,1,0.007574867880211391,1,0.0
magnificence,0,0,1,0.007574867880211391,1,0.0
jazzy,1,0,1,-0.0001174398120963021,2,1.0
irrelevant,2,0,0,-0.015443335290663537,2,1.0
slither,0,0,1,0.007574867880211391,1,0.0
sleekest,0,0,1,0.007574867880211391,1,0.0
sexiest,0,0,1,0.007574867880211391,1,0.0
cabaret,0,0,1,0.007574867880211391,1,0.0
scintillate,0,0,1,0.007574867880211391,1,0.0
sardonic,0,0,2,0.015208455666470933,2,1.0
shout,2,0,1,-0.007809747504403995,3,1.5849625007211563
nasty,4,0,5,0.007339988256018788,9,3.1699250014423126
entertainingly,0,0,2,0.015208455666470933,2,1.0
splashy,0,0,1,0.007574867880211391,1,0.0
purposeful,1,0,1,-0.0001174398120963021,2,1.0
humming,0,0,1,0.007574867880211391,1,0.0
rouge,0,0,1,0.007574867880211391,1,0.0
respites,0,0,1,0.007574867880211391,1,0.0
overdoing,0,0,1,0.007574867880211391,1,0.0
edits,0,0,1,0.007574867880211391,1,0.0
moulin,0,0,1,0.007574867880211391,1,0.0
flammable,0,0,1,0.007574867880211391,1,0.0
delicious,0,0,3,0.022842043452730474,3,1.5849625007211563
leggy,0,0,1,0.007574867880211391,1,0.0
spare,0,0,2,0.015208455666470933,2,1.0
razzle,0,0,1,0.007574867880211391,1,0.0
dazzle,0,0,1,0.007574867880211391,1,0.0
stylish,4,0,4,-0.00029359953024075264,8,3.0
intact,0,0,1,0.007574867880211391,1,0.0
transition,0,0,1,0.007574867880211391,1,0.0
translate,1,0,1,-0.0001174398120963021,2,1.0
slip,1,0,1,-0.0001174398120963021,2,1.0
stirred,0,0,1,0.007574867880211391,1,0.0
hack,2,0,1,-0.007809747504403995,3,1.5849625007211563
goodfellas,2,0,3,0.0074574280681150885,5,2.321928094887362
derivative,6,0,4,-0.015678214914856138,10,3.3219280948873626
scorsese,6,0,11,0.037756899588960655,17,4.08746284125034
promisingly,2,0,0,-0.015443335290663537,2,1.0
maudlin,2,0,1,-0.007809747504403995,3,1.5849625007211563
suggests,3,0,1,-0.015502055196711688,4,2.0
sensationalize,1,0,0,-0.007751027598355844,1,0.0
sabotaged,2,0,0,-0.015443335290663537,2,1.0
mcdormand,2,0,0,-0.015443335290663537,2,1.0
inability,1,0,1,-0.0001174398120963021,2,1.0
testament,2,0,4,0.015091015854374633,6,2.584962500721156
caton,0,0,1,0.007574867880211391,1,0.0
dynamics,1,0,1,-0.0001174398120963021,2,1.0
cry,3,0,1,-0.015502055196711688,4,2.0
cries,1,0,0,-0.007751027598355844,1,0.0
inactive,1,0,0,-0.007751027598355844,1,0.0
bordering,2,0,0,-0.015443335290663537,2,1.0
markedly,1,0,0,-0.007751027598355844,1,0.0
conversational,1,0,0,-0.007751027598355844,1,0.0
trump,1,0,0,-0.007751027598355844,1,0.0
section,3,0,0,-0.02313564298297123,3,1.5849625007211563
mid,3,0,1,-0.015502055196711688,4,2.0
card,2,0,0,-0.015443335290663537,2,1.0
virtually,7,0,1,-0.04627128596594246,8,3.0
esfera,0,0,1,0.007574867880211391,1,0.0
adicional,0,0,1,0.007574867880211391,1,0.0
ao,0,0,1,0.007574867880211391,1,0.0
força,0,0,1,0.007574867880211391,1,0.0
funcionar,0,0,1,0.007574867880211391,1,0.0
suspeito,0,0,1,0.007574867880211391,1,0.0
ganha,0,0,1,0.007574867880211391,1,0.0
último,0,0,1,0.007574867880211391,1,0.0
creativity,5,0,3,-0.01561949500880799,8,3.0
introduced,1,0,0,-0.007751027598355844,1,0.0
peak,2,0,0,-0.015443335290663537,2,1.0
villians,1,0,0,-0.007751027598355844,1,0.0
snake,3,0,0,-0.02313564298297123,3,1.5849625007211563
ain,3,0,4,0.00739870816206694,7,2.807354922057604
interpersonal,0,0,1,0.007574867880211391,1,0.0
cliches,13,0,7,-0.046623605402231365,20,4.321928094887363
concentrate,0,0,1,0.007574867880211391,1,0.0
earthbounda,1,0,0,-0.007751027598355844,1,0.0
soporific,1,0,0,-0.007751027598355844,1,0.0
dank,1,0,0,-0.007751027598355844,1,0.0
stellar,1,0,1,-0.0001174398120963021,2,1.0
divided,1,0,0,-0.007751027598355844,1,0.0
portrays,3,0,2,-0.007868467410452145,5,2.321928094887362
boardwalk,1,0,0,-0.007751027598355844,1,0.0
wasted,7,0,0,-0.053904873752202,7,2.807354922057604
grand,3,0,4,0.00739870816206694,7,2.807354922057604
nirois,0,0,1,0.007574867880211391,1,0.0
veritable,0,0,2,0.015208455666470933,2,1.0
recording,1,0,4,0.022783323546682326,5,2.321928094887362
conversations,1,0,0,-0.007751027598355844,1,0.0
wal,2,0,0,-0.015443335290663537,2,1.0
freeway,1,0,1,-0.0001174398120963021,2,1.0
defensive,2,0,0,-0.015443335290663537,2,1.0
persuasive,1,0,0,-0.007751027598355844,1,0.0
conscientious,2,0,0,-0.015443335290663537,2,1.0
saves,1,0,1,-0.0001174398120963021,2,1.0
careful,3,0,2,-0.007868467410452145,5,2.321928094887362
afforded,1,0,0,-0.007751027598355844,1,0.0
asbury,1,0,0,-0.007751027598355844,1,0.0
springsteen,1,0,0,-0.007751027598355844,1,0.0
sack,2,0,0,-0.015443335290663537,2,1.0
humanizing,0,0,2,0.015208455666470933,2,1.0
fuzzy,2,0,0,-0.015443335290663537,2,1.0
plods,1,0,0,-0.007751027598355844,1,0.0
reading,4,0,5,0.007339988256018788,9,3.1699250014423126
underscores,1,0,0,-0.007751027598355844,1,0.0
coherence,1,0,1,-0.0001174398120963021,2,1.0
polishing,1,0,0,-0.007751027598355844,1,0.0
sentimentality,4,0,2,-0.015560775102759838,6,2.584962500721156
caricature,0,0,2,0.015208455666470933,2,1.0
lucratively,0,0,1,0.007574867880211391,1,0.0
1999,0,0,2,0.015208455666470933,2,1.0
realistically,0,0,2,0.015208455666470933,2,1.0
smaller,2,0,1,-0.007809747504403995,3,1.5849625007211563
affecting,1,0,5,0.030416911332941866,6,2.584962500721156
exposition,3,0,0,-0.02313564298297123,3,1.5849625007211563
titular,2,0,1,-0.007809747504403995,3,1.5849625007211563
sands,1,0,0,-0.007751027598355844,1,0.0
larded,1,0,0,-0.007751027598355844,1,0.0
scruffy,3,0,0,-0.02313564298297123,3,1.5849625007211563
wound,1,0,0,-0.007751027598355844,1,0.0
participation,1,0,0,-0.007751027598355844,1,0.0
tnt,1,0,0,-0.007751027598355844,1,0.0
blare,1,0,0,-0.007751027598355844,1,0.0
stomp,1,0,0,-0.007751027598355844,1,0.0
disgust,2,0,1,-0.007809747504403995,3,1.5849625007211563
colour,0,0,2,0.015208455666470933,2,1.0
photographed,1,0,4,0.022783323546682326,5,2.321928094887362
betrayed,1,0,0,-0.007751027598355844,1,0.0
makeup,3,0,0,-0.02313564298297123,3,1.5849625007211563
ages,1,0,11,0.07621843805049912,12,3.5849625007211565
clockstoppers,6,0,2,-0.030945390487375223,8,3.0
sillified,1,0,0,-0.007751027598355844,1,0.0
stultifying,2,0,0,-0.015443335290663537,2,1.0
slave,0,0,1,0.007574867880211391,1,0.0
fantasies,0,0,2,0.015208455666470933,2,1.0
94,1,0,1,-0.0001174398120963021,2,1.0
generally,2,0,9,0.053258954785672344,11,3.4594316186372978
wildest,0,0,1,0.007574867880211391,1,0.0
traveler,0,0,1,0.007574867880211391,1,0.0
reverse,1,0,0,-0.007751027598355844,1,0.0
mixed,10,0,1,-0.06934820904286554,11,3.4594316186372978
battery,1,0,0,-0.007751027598355844,1,0.0
dime,1,0,0,-0.007751027598355844,1,0.0
longest,1,0,0,-0.007751027598355844,1,0.0
literally,5,0,3,-0.01561949500880799,8,3.0
lawn,1,0,0,-0.007751027598355844,1,0.0
chair,2,0,0,-0.015443335290663537,2,1.0
rote,3,0,1,-0.015502055196711688,4,2.0
effects,13,0,16,0.02207868467410451,29,4.857980995127573
timer,1,0,0,-0.007751027598355844,1,0.0
93,2,0,0,-0.015443335290663537,2,1.0
gussied,1,0,0,-0.007751027598355844,1,0.0
unspectacular,1,0,1,-0.0001174398120963021,2,1.0
upper,2,0,1,-0.007809747504403995,3,1.5849625007211563
numbered,1,0,0,-0.007751027598355844,1,0.0
faster,4,0,1,-0.023194362889019382,5,2.321928094887362
kidlets,2,0,0,-0.015443335290663537,2,1.0
disservice,1,0,0,-0.007751027598355844,1,0.0
advantage,2,0,1,-0.007809747504403995,3,1.5849625007211563
sci,16,0,11,-0.03916617733411627,27,4.754887502163469
fi,16,0,12,-0.03153258954785673,28,4.807354922057604
wishing,2,0,2,-0.00017615971814445228,4,2.0
grinds,2,0,0,-0.015443335290663537,2,1.0
grosses,1,0,0,-0.007751027598355844,1,0.0
backed,1,0,0,-0.007751027598355844,1,0.0
voyeuristic,1,0,0,-0.007751027598355844,1,0.0
fleet,0,0,2,0.015208455666470933,2,1.0
pleasingly,0,0,1,0.007574867880211391,1,0.0
footed,0,0,1,0.007574867880211391,1,0.0
upbeat,0,0,2,0.015208455666470933,2,1.0
slogged,1,0,0,-0.007751027598355844,1,0.0
stopped,3,0,1,-0.015502055196711688,4,2.0
benign,1,0,0,-0.007751027598355844,1,0.0
interminable,1,0,0,-0.007751027598355844,1,0.0
scientific,1,0,0,-0.007751027598355844,1,0.0
speeds,1,0,1,-0.0001174398120963021,2,1.0
heed,1,0,0,-0.007751027598355844,1,0.0
discerned,1,0,0,-0.007751027598355844,1,0.0
attract,3,0,0,-0.02313564298297123,3,1.5849625007211563
teenagers,3,0,1,-0.015502055196711688,4,2.0
pizazz,1,0,0,-0.007751027598355844,1,0.0
innovation,2,0,1,-0.007809747504403995,3,1.5849625007211563
slot,0,0,1,0.007574867880211391,1,0.0
shopping,0,0,2,0.015208455666470933,2,1.0
destined,0,0,2,0.015208455666470933,2,1.0
unpretentious,0,0,4,0.03047563123899002,4,2.0
yawn,1,0,0,-0.007751027598355844,1,0.0
troubling,1,0,0,-0.007751027598355844,1,0.0
schwarzenegger,4,0,2,-0.015560775102759838,6,2.584962500721156
excruciating,2,0,0,-0.015443335290663537,2,1.0
expressions,2,0,1,-0.007809747504403995,3,1.5849625007211563
facial,3,0,0,-0.02313564298297123,3,1.5849625007211563
sympathizing,1,0,0,-0.007751027598355844,1,0.0
presenting,1,0,1,-0.0001174398120963021,2,1.0
motivations,2,0,2,-0.00017615971814445228,4,2.0
seal,1,0,0,-0.007751027598355844,1,0.0
sorry,2,0,1,-0.007809747504403995,3,1.5849625007211563
resonance,3,0,1,-0.015502055196711688,4,2.0
arnie,2,0,1,-0.007809747504403995,3,1.5849625007211563
insultingly,2,0,2,-0.00017615971814445228,4,2.0
musclefest,0,0,1,0.007574867880211391,1,0.0
sadism,1,0,0,-0.007751027598355844,1,0.0
pulp,2,0,0,-0.015443335290663537,2,1.0
learned,2,0,0,-0.015443335290663537,2,1.0
absurdly,3,0,0,-0.02313564298297123,3,1.5849625007211563
letdown,2,0,0,-0.015443335290663537,2,1.0
relative,1,0,0,-0.007751027598355844,1,0.0
eyeballs,1,0,0,-0.007751027598355844,1,0.0
fingernails,1,0,0,-0.007751027598355844,1,0.0
crawled,1,0,0,-0.007751027598355844,1,0.0
gymkata,1,0,0,-0.007751027598355844,1,0.0
howie,1,0,0,-0.007751027598355844,1,0.0
similarities,1,0,0,-0.007751027598355844,1,0.0
firestorm,1,0,0,-0.007751027598355844,1,0.0
instinctively,1,0,0,-0.007751027598355844,1,0.0
relevant,1,0,2,0.0075161479741632405,3,1.5849625007211563
operates,1,0,3,0.015149735760422781,4,2.0
aura,0,0,2,0.015208455666470933,2,1.0
climate,0,0,3,0.022842043452730474,3,1.5849625007211563
estafeta,1,0,0,-0.007751027598355844,1,0.0
deje,1,0,0,-0.007751027598355844,1,0.0
nuevas,1,0,0,-0.007751027598355844,1,0.0
hora,1,0,0,-0.007751027598355844,1,0.0
pero,2,0,1,-0.007809747504403995,3,1.5849625007211563
generaciones,1,0,0,-0.007751027598355844,1,0.0
lástima,1,0,0,-0.007751027598355844,1,0.0
las,1,0,1,-0.0001174398120963021,2,1.0
tantamount,1,0,0,-0.007751027598355844,1,0.0
sept,1,0,0,-0.007751027598355844,1,0.0
insulting,2,0,1,-0.007809747504403995,3,1.5849625007211563
absurdities,2,0,1,-0.007809747504403995,3,1.5849625007211563
inescapable,3,0,0,-0.02313564298297123,3,1.5849625007211563
manufactured,3,0,0,-0.02313564298297123,3,1.5849625007211563
exploitation,5,0,1,-0.030886670581327075,6,2.584962500721156
clumsily,5,0,0,-0.038520258367586616,5,2.321928094887362
remembered,3,0,2,-0.007868467410452145,5,2.321928094887362
bother,2,0,1,-0.007809747504403995,3,1.5849625007211563
remembering,1,0,1,-0.0001174398120963021,2,1.0
9,4,0,2,-0.015560775102759838,6,2.584962500721156
ashamed,0,0,1,0.007574867880211391,1,0.0
dish,1,0,3,0.015149735760422781,4,2.0
enjoyment,1,0,2,0.0075161479741632405,3,1.5849625007211563
reps,1,0,0,-0.007751027598355844,1,0.0
suspend,3,0,1,-0.015502055196711688,4,2.0
disbelief,5,0,2,-0.02325308279506753,7,2.807354922057604
reactionary,1,0,1,-0.0001174398120963021,2,1.0
trajectory,1,0,1,-0.0001174398120963021,2,1.0
blows,1,0,1,-0.0001174398120963021,2,1.0
provocation,1,0,0,-0.007751027598355844,1,0.0
antique,1,0,0,-0.007751027598355844,1,0.0
obliviousness,1,0,0,-0.007751027598355844,1,0.0
nuld,1,0,0,-0.007751027598355844,1,0.0
glossy,5,0,2,-0.02325308279506753,7,2.807354922057604
inevitable,2,0,0,-0.015443335290663537,2,1.0
outrunning,1,0,0,-0.007751027598355844,1,0.0
fireball,1,0,0,-0.007751027598355844,1,0.0
embarrassing,2,0,0,-0.015443335290663537,2,1.0
september,2,0,0,-0.015443335290663537,2,1.0
straddles,1,0,0,-0.007751027598355844,1,0.0
skillfully,0,0,3,0.022842043452730474,3,1.5849625007211563
stasis,1,0,0,-0.007751027598355844,1,0.0
mired,3,0,0,-0.02313564298297123,3,1.5849625007211563
earns,0,0,3,0.022842043452730474,3,1.5849625007211563
weren,1,0,2,0.0075161479741632405,3,1.5849625007211563
trash,5,0,3,-0.01561949500880799,8,3.0
burly,1,0,0,-0.007751027598355844,1,0.0
necessity,1,0,0,-0.007751027598355844,1,0.0
coincidence,1,0,0,-0.007751027598355844,1,0.0
roundhouse,1,0,0,-0.007751027598355844,1,0.0
pummels,1,0,0,-0.007751027598355844,1,0.0
drunken,2,0,0,-0.015443335290663537,2,1.0
correctly,1,0,1,-0.0001174398120963021,2,1.0
tend,1,0,1,-0.0001174398120963021,2,1.0
pyro,1,0,0,-0.007751027598355844,1,0.0
slippery,1,0,1,-0.0001174398120963021,2,1.0
lessons,3,0,3,-0.0002348796241926042,6,2.584962500721156
concoction,1,0,2,0.0075161479741632405,3,1.5849625007211563
clooney,1,0,12,0.08385202583675866,13,3.700439718141092
takeoff,1,0,0,-0.007751027598355844,1,0.0
lets,2,0,8,0.0456253669994128,10,3.3219280948873626
pity,2,0,2,-0.00017615971814445228,4,2.0
herky,0,0,1,0.007574867880211391,1,0.0
tag,2,0,2,-0.00017615971814445228,4,2.0
coen,0,0,3,0.022842043452730474,3,1.5849625007211563
gong,2,0,2,-0.00017615971814445228,4,2.0
labored,3,0,0,-0.02313564298297123,3,1.5849625007211563
crassly,1,0,0,-0.007751027598355844,1,0.0
comedically,1,0,0,-0.007751027598355844,1,0.0
revelatory,1,0,1,-0.0001174398120963021,2,1.0
spin,1,0,2,0.0075161479741632405,3,1.5849625007211563
gorgeous,4,0,7,0.02260716382853787,11,3.4594316186372978
icing,0,0,1,0.007574867880211391,1,0.0
cake,1,0,1,-0.0001174398120963021,2,1.0
approved,0,0,1,0.007574867880211391,1,0.0
são,1,0,1,-0.0001174398120963021,2,1.0
os,2,0,3,0.0074574280681150885,5,2.321928094887362
universos,0,0,1,0.007574867880211391,1,0.0
igualmente,0,0,1,0.007574867880211391,1,0.0
complementares,0,0,1,0.007574867880211391,1,0.0
fascinantes,0,0,1,0.007574867880211391,1,0.0
hat,3,0,2,-0.007868467410452145,5,2.321928094887362
ought,3,0,1,-0.015502055196711688,4,2.0
stylized,3,0,3,-0.0002348796241926042,6,2.584962500721156
fever,0,0,1,0.007574867880211391,1,0.0
recollections,0,0,1,0.007574867880211391,1,0.0
dreamlike,0,0,1,0.007574867880211391,1,0.0
rockwell,0,0,1,0.007574867880211391,1,0.0
hunk,0,0,1,0.007574867880211391,1,0.0
sheer,2,0,7,0.037991779213153255,9,3.1699250014423126
audacity,0,0,1,0.007574867880211391,1,0.0
reinforces,0,0,1,0.007574867880211391,1,0.0
creator,0,0,1,0.007574867880211391,1,0.0
tedious,7,0,2,-0.03863769817968292,9,3.1699250014423126
boast,1,0,0,-0.007751027598355844,1,0.0
sharply,0,0,1,0.007574867880211391,1,0.0
kooky,0,0,1,0.007574867880211391,1,0.0
shadowy,0,0,1,0.007574867880211391,1,0.0
sustains,0,0,4,0.03047563123899002,4,2.0
bow,3,0,7,0.030299471520845563,10,3.3219280948873626
collaborators,0,0,2,0.015208455666470933,2,1.0
prescription,0,0,1,0.007574867880211391,1,0.0
fashioning,0,0,1,0.007574867880211391,1,0.0
complaint,0,0,1,0.007574867880211391,1,0.0
creations,1,0,2,0.0075161479741632405,3,1.5849625007211563
sublime,0,0,2,0.015208455666470933,2,1.0
confusions,0,0,1,0.007574867880211391,1,0.0
architect,0,0,1,0.007574867880211391,1,0.0
straightforward,0,0,2,0.015208455666470933,2,1.0
blowing,2,0,1,-0.007809747504403995,3,1.5849625007211563
indicate,1,0,0,-0.007751027598355844,1,0.0
overstuffed,1,0,0,-0.007751027598355844,1,0.0
undernourished,2,0,0,-0.015443335290663537,2,1.0
tightened,1,0,0,-0.007751027598355844,1,0.0
hoot,1,0,1,-0.0001174398120963021,2,1.0
laborious,2,0,0,-0.015443335290663537,2,1.0
ludicrous,4,0,1,-0.023194362889019382,5,2.321928094887362
showed,0,0,1,0.007574867880211391,1,0.0
paved,0,0,1,0.007574867880211391,1,0.0
purports,2,0,0,-0.015443335290663537,2,1.0
lynch,0,0,2,0.015208455666470933,2,1.0
stuttering,1,0,0,-0.007751027598355844,1,0.0
salle,1,0,1,-0.0001174398120963021,2,1.0
professionals,1,0,0,-0.007751027598355844,1,0.0
allegory,2,0,0,-0.015443335290663537,2,1.0
obscure,2,0,1,-0.007809747504403995,3,1.5849625007211563
overachieving,1,0,0,-0.007751027598355844,1,0.0
chronically,1,0,0,-0.007751027598355844,1,0.0
verbal,2,0,3,0.0074574280681150885,5,2.321928094887362
duel,0,0,1,0.007574867880211391,1,0.0
gifted,0,0,5,0.03810921902524956,5,2.321928094887362
wills,3,0,0,-0.02313564298297123,3,1.5849625007211563
reiterates,1,0,0,-0.007751027598355844,1,0.0
dramatically,2,0,0,-0.015443335290663537,2,1.0
shaky,2,0,0,-0.015443335290663537,2,1.0
rigid,2,0,0,-0.015443335290663537,2,1.0
sixth,1,0,0,-0.007751027598355844,1,0.0
brazenly,1,0,0,-0.007751027598355844,1,0.0
asinine,1,0,0,-0.007751027598355844,1,0.0
hampered,2,0,0,-0.015443335290663537,2,1.0
rips,1,0,0,-0.007751027598355844,1,0.0
faulted,1,0,0,-0.007751027598355844,1,0.0
phoniness,1,0,0,-0.007751027598355844,1,0.0
listless,3,0,0,-0.02313564298297123,3,1.5849625007211563
compared,2,0,5,0.022724603640634174,7,2.807354922057604
morose,2,0,2,-0.00017615971814445228,4,2.0
threads,1,0,0,-0.007751027598355844,1,0.0
pregnancy,1,0,0,-0.007751027598355844,1,0.0
puzzles,1,0,0,-0.007751027598355844,1,0.0
characterized,2,0,1,-0.007809747504403995,3,1.5849625007211563
shallowly,1,0,0,-0.007751027598355844,1,0.0
plotted,3,0,4,0.00739870816206694,7,2.807354922057604
crossroads,6,0,1,-0.03857897827363477,7,2.807354922057604
shorter,1,0,1,-0.0001174398120963021,2,1.0
cutoffs,1,0,0,-0.007751027598355844,1,0.0
lacking,11,0,5,-0.04650616559013506,16,4.0
impatiently,1,0,0,-0.007751027598355844,1,0.0
whenever,4,0,0,-0.030827950675278923,4,2.0
squinting,1,0,1,-0.0001174398120963021,2,1.0
prepubescent,1,0,0,-0.007751027598355844,1,0.0
muttering,1,0,0,-0.007751027598355844,1,0.0
dissing,2,0,0,-0.015443335290663537,2,1.0
smartly,0,0,5,0.03810921902524956,5,2.321928094887362
plate,1,0,1,-0.0001174398120963021,2,1.0
tends,2,0,2,-0.00017615971814445228,4,2.0
merit,4,0,0,-0.030827950675278923,4,2.0
scandalous,1,0,0,-0.007751027598355844,1,0.0
flaccid,3,0,0,-0.02313564298297123,3,1.5849625007211563
teenybopper,1,0,0,-0.007751027598355844,1,0.0
strung,2,0,0,-0.015443335290663537,2,1.0
innuendo,1,0,0,-0.007751027598355844,1,0.0
wood,4,0,0,-0.030827950675278923,4,2.0
content,4,0,0,-0.030827950675278923,4,2.0
videos,2,0,0,-0.015443335290663537,2,1.0
101,1,0,2,0.0075161479741632405,3,1.5849625007211563
howlers,1,0,0,-0.007751027598355844,1,0.0
smiles,2,0,1,-0.007809747504403995,3,1.5849625007211563
afterschool,2,0,0,-0.015443335290663537,2,1.0
yawns,1,0,0,-0.007751027598355844,1,0.0
freshened,1,0,0,-0.007751027598355844,1,0.0
handful,5,0,1,-0.030886670581327075,6,2.584962500721156
dunce,1,0,0,-0.007751027598355844,1,0.0
abc,1,0,0,-0.007751027598355844,1,0.0
bubbly,1,0,2,0.0075161479741632405,3,1.5849625007211563
playful,0,0,3,0.022842043452730474,3,1.5849625007211563
kitten,1,0,0,-0.007751027598355844,1,0.0
borrows,3,0,1,-0.015502055196711688,4,2.0
queens,1,0,0,-0.007751027598355844,1,0.0
butterflies,1,0,1,-0.0001174398120963021,2,1.0
puppies,1,0,0,-0.007751027598355844,1,0.0
legs,1,0,0,-0.007751027598355844,1,0.0
lumbering,2,0,0,-0.015443335290663537,2,1.0
hokum,1,0,1,-0.0001174398120963021,2,1.0
load,3,0,0,-0.02313564298297123,3,1.5849625007211563
slog,1,0,0,-0.007751027598355844,1,0.0
chick,4,0,2,-0.015560775102759838,6,2.584962500721156
exclusively,1,0,0,-0.007751027598355844,1,0.0
preach,1,0,0,-0.007751027598355844,1,0.0
converted,2,0,0,-0.015443335290663537,2,1.0
superstar,1,0,1,-0.0001174398120963021,2,1.0
infomercial,1,0,0,-0.007751027598355844,1,0.0
popped,1,0,0,-0.007751027598355844,1,0.0
songbird,1,0,0,-0.007751027598355844,1,0.0
chirpy,1,0,0,-0.007751027598355844,1,0.0
oops,3,0,0,-0.02313564298297123,3,1.5849625007211563
drivel,1,0,0,-0.007751027598355844,1,0.0
signs,5,0,8,0.022548443922489725,13,3.700439718141092
servitude,1,0,0,-0.007751027598355844,1,0.0
glaring,1,0,0,-0.007751027598355844,1,0.0
skirts,1,0,0,-0.007751027598355844,1,0.0
ms,3,0,3,-0.0002348796241926042,6,2.584962500721156
concerned,3,0,3,-0.0002348796241926042,6,2.584962500721156
product,6,0,0,-0.04621256605989431,6,2.584962500721156
fabulous,1,0,0,-0.007751027598355844,1,0.0
gentlemen,1,0,0,-0.007751027598355844,1,0.0
cellophane,1,0,0,-0.007751027598355844,1,0.0
inconsequential,6,0,2,-0.030945390487375223,8,3.0
remake,12,0,6,-0.04656488549618321,18,4.169925001442312
punk,1,0,1,-0.0001174398120963021,2,1.0
stainscrossroads,1,0,0,-0.007751027598355844,1,0.0
empathize,0,0,2,0.015208455666470933,2,1.0
refusal,0,0,1,0.007574867880211391,1,0.0
shock,4,0,5,0.007339988256018788,9,3.1699250014423126
meltdown,0,0,1,0.007574867880211391,1,0.0
climaxing,0,0,1,0.007574867880211391,1,0.0
cringe,0,0,2,0.015208455666470933,2,1.0
solipsism,0,0,1,0.007574867880211391,1,0.0
devolves,2,0,1,-0.007809747504403995,3,1.5849625007211563
cassavetes,2,0,1,-0.007809747504403995,3,1.5849625007211563
anguish,1,0,1,-0.0001174398120963021,2,1.0
decrying,1,0,0,-0.007751027598355844,1,0.0
clout,0,0,1,0.007574867880211391,1,0.0
added,1,0,1,-0.0001174398120963021,2,1.0
doc,0,0,2,0.015208455666470933,2,1.0
illusion,2,0,1,-0.007809747504403995,3,1.5849625007211563
deconstructed,0,0,1,0.007574867880211391,1,0.0
treatise,0,0,2,0.015208455666470933,2,1.0
strides,0,0,1,0.007574867880211391,1,0.0
histo,0,0,1,0.007574867880211391,1,0.0
unmentioned,0,0,1,0.007574867880211391,1,0.0
philosophers,0,0,1,0.007574867880211391,1,0.0
engage,2,0,5,0.022724603640634174,7,2.807354922057604
berlinger,0,0,1,0.007574867880211391,1,0.0
commanding,0,0,1,0.007574867880211391,1,0.0
draining,0,0,1,0.007574867880211391,1,0.0
sinofsky,0,0,1,0.007574867880211391,1,0.0
paradise,0,0,2,0.015208455666470933,2,1.0
frederick,0,0,1,0.007574867880211391,1,0.0
wiseman,0,0,1,0.007574867880211391,1,0.0
trauma,0,0,1,0.007574867880211391,1,0.0
stark,0,0,1,0.007574867880211391,1,0.0
casualties,0,0,1,0.007574867880211391,1,0.0
flinch,0,0,1,0.007574867880211391,1,0.0
wounds,0,0,2,0.015208455666470933,2,1.0
prognosis,0,0,1,0.007574867880211391,1,0.0
perpetual,1,0,1,-0.0001174398120963021,2,1.0
youngster,0,0,1,0.007574867880211391,1,0.0
franco,1,0,2,0.0075161479741632405,3,1.5849625007211563
assimilated,0,0,1,0.007574867880211391,1,0.0
eagerly,0,0,1,0.007574867880211391,1,0.0
dolgin,0,0,1,0.007574867880211391,1,0.0
craftily,0,0,1,0.007574867880211391,1,0.0
intuit,0,0,1,0.007574867880211391,1,0.0
disillusionment,0,0,1,0.007574867880211391,1,0.0
arc,0,0,3,0.022842043452730474,3,1.5849625007211563
euphoria,0,0,1,0.007574867880211391,1,0.0
quarter,5,0,1,-0.030886670581327075,6,2.584962500721156
heal,1,0,1,-0.0001174398120963021,2,1.0
specific,1,0,1,-0.0001174398120963021,2,1.0
tangle,0,0,1,0.007574867880211391,1,0.0
unbearable,1,0,2,0.0075161479741632405,3,1.5849625007211563
ties,0,0,2,0.015208455666470933,2,1.0
presumption,0,0,1,0.007574867880211391,1,0.0
loss,0,0,5,0.03810921902524956,5,2.321928094887362
sundance,0,0,4,0.03047563123899002,4,2.0
understandably,0,0,1,0.007574867880211391,1,0.0
nonfiction,0,0,1,0.007574867880211391,1,0.0
incorporates,0,0,1,0.007574867880211391,1,0.0
divisions,0,0,1,0.007574867880211391,1,0.0
normal,0,0,1,0.007574867880211391,1,0.0
dv,0,0,1,0.007574867880211391,1,0.0
discreet,0,0,1,0.007574867880211391,1,0.0
ford,4,0,3,-0.007927187316500297,7,2.807354922057604
documentaries,0,0,3,0.022842043452730474,3,1.5849625007211563
tearing,0,0,1,0.007574867880211391,1,0.0
complicity,0,0,1,0.007574867880211391,1,0.0
patronizing,0,0,1,0.007574867880211391,1,0.0
masked,0,0,1,0.007574867880211391,1,0.0
represented,0,0,1,0.007574867880211391,1,0.0
injustice,0,0,2,0.015208455666470933,2,1.0
suspended,0,0,1,0.007574867880211391,1,0.0
poignant,2,0,3,0.0074574280681150885,5,2.321928094887362
punch,5,0,6,0.007281268349970636,11,3.4594316186372978
outnumber,1,0,0,-0.007751027598355844,1,0.0
bitter,5,0,0,-0.038520258367586616,5,2.321928094887362
firing,3,0,0,-0.02313564298297123,3,1.5849625007211563
twisted,1,0,4,0.022783323546682326,5,2.321928094887362
barney,1,0,1,-0.0001174398120963021,2,1.0
serpico,0,0,1,0.007574867880211391,1,0.0
williams,10,0,13,0.022254844392248965,23,4.523561956057013
tiresome,4,0,0,-0.030827950675278923,4,2.0
anarchy,1,0,0,-0.007751027598355844,1,0.0
surgical,1,0,0,-0.007751027598355844,1,0.0
resnick,1,0,1,-0.0001174398120963021,2,1.0
pound,1,0,0,-0.007751027598355844,1,0.0
devito,2,0,2,-0.00017615971814445228,4,2.0
robin,4,0,5,0.007339988256018788,9,3.1699250014423126
similar,5,0,0,-0.038520258367586616,5,2.321928094887362
shakes,2,0,0,-0.015443335290663537,2,1.0
stepdad,0,0,1,0.007574867880211391,1,0.0
adjusting,0,0,1,0.007574867880211391,1,0.0
freshly,0,0,1,0.007574867880211391,1,0.0
venomous,0,0,1,0.007574867880211391,1,0.0
verve,0,0,3,0.022842043452730474,3,1.5849625007211563
revive,0,0,1,0.007574867880211391,1,0.0
intent,2,0,1,-0.007809747504403995,3,1.5849625007211563
demented,3,0,0,-0.02313564298297123,3,1.5849625007211563
gaudy,1,0,0,-0.007751027598355844,1,0.0
halloween,8,0,3,-0.03869641808573107,11,3.4594316186372978
acquired,0,0,1,0.007574867880211391,1,0.0
sappy,5,0,4,-0.007985907222548445,9,3.1699250014423126
innocuous,1,0,1,-0.0001174398120963021,2,1.0
degrees,0,0,1,0.007574867880211391,1,0.0
fiascoes,0,0,1,0.007574867880211391,1,0.0
180,0,0,1,0.007574867880211391,1,0.0
holy,1,0,2,0.0075161479741632405,3,1.5849625007211563
rude,2,0,2,-0.00017615971814445228,4,2.0
catalytic,0,0,1,0.007574867880211391,1,0.0
sinister,1,0,3,0.015149735760422781,4,2.0
fuelled,1,0,0,-0.007751027598355844,1,0.0
payola,1,0,0,-0.007751027598355844,1,0.0
devitoattempts,1,0,0,-0.007751027598355844,1,0.0
rattling,1,0,1,-0.0001174398120963021,2,1.0
beside,1,0,0,-0.007751027598355844,1,0.0
spotty,1,0,0,-0.007751027598355844,1,0.0
teeth,3,0,2,-0.007868467410452145,5,2.321928094887362
vid,1,0,0,-0.007751027598355844,1,0.0
lashing,1,0,0,-0.007751027598355844,1,0.0
hypocrisy,2,0,1,-0.007809747504403995,3,1.5849625007211563
banality,1,0,0,-0.007751027598355844,1,0.0
platter,1,0,1,-0.0001174398120963021,2,1.0
gods,1,0,0,-0.007751027598355844,1,0.0
dependable,1,0,0,-0.007751027598355844,1,0.0
sherman,0,0,1,0.007574867880211391,1,0.0
colossal,0,0,1,0.007574867880211391,1,0.0
cynicism,2,0,3,0.0074574280681150885,5,2.321928094887362
idiot,1,0,1,-0.0001174398120963021,2,1.0
parody,2,0,3,0.0074574280681150885,5,2.321928094887362
pull,2,0,5,0.022724603640634174,7,2.807354922057604
coke,1,0,0,-0.007751027598355844,1,0.0
unpleasant,7,0,2,-0.03863769817968292,9,3.1699250014423126
annals,1,0,2,0.0075161479741632405,3,1.5849625007211563
inexplicable,1,0,1,-0.0001174398120963021,2,1.0
oldie,1,0,0,-0.007751027598355844,1,0.0
moldy,1,0,0,-0.007751027598355844,1,0.0
misanthropic,0,0,1,0.007574867880211391,1,0.0
salvos,1,0,0,-0.007751027598355844,1,0.0
discernible,2,0,0,-0.015443335290663537,2,1.0
jaundiced,1,0,0,-0.007751027598355844,1,0.0
palatable,1,0,2,0.0075161479741632405,3,1.5849625007211563
bonbon,1,0,0,-0.007751027598355844,1,0.0
empathy,3,0,2,-0.007868467410452145,5,2.321928094887362
tart,2,0,0,-0.015443335290663537,2,1.0
insider,1,0,0,-0.007751027598355844,1,0.0
rancorous,1,0,0,-0.007751027598355844,1,0.0
apparent,6,0,1,-0.03857897827363477,7,2.807354922057604
sneers,0,0,1,0.007574867880211391,1,0.0
bile,0,0,1,0.007574867880211391,1,0.0
tear,0,0,2,0.015208455666470933,2,1.0
expiration,1,0,0,-0.007751027598355844,1,0.0
fuhgeddaboutit,1,0,0,-0.007751027598355844,1,0.0
grease,2,0,0,-0.015443335290663537,2,1.0
resembles,3,0,1,-0.015502055196711688,4,2.0
benefit,3,0,0,-0.02313564298297123,3,1.5849625007211563
nostalgia,5,0,1,-0.030886670581327075,6,2.584962500721156
tweaked,1,0,0,-0.007751027598355844,1,0.0
sketch,2,0,0,-0.015443335290663537,2,1.0
sha,1,0,0,-0.007751027598355844,1,0.0
punctuated,1,0,2,0.0075161479741632405,3,1.5849625007211563
graphic,4,0,1,-0.023194362889019382,5,2.321928094887362
elaborate,3,0,0,-0.02313564298297123,3,1.5849625007211563
exit,2,0,0,-0.015443335290663537,2,1.0
choreography,2,0,0,-0.015443335290663537,2,1.0
finger,1,0,0,-0.007751027598355844,1,0.0
snapping,1,0,0,-0.007751027598355844,1,0.0
broke,1,0,1,-0.0001174398120963021,2,1.0
delinquent,1,0,1,-0.0001174398120963021,2,1.0
paperbacks,1,0,0,-0.007751027598355844,1,0.0
redone,1,0,0,-0.007751027598355844,1,0.0
sexpot,1,0,0,-0.007751027598355844,1,0.0
leather,2,0,1,-0.007809747504403995,3,1.5849625007211563
warriors,2,0,1,-0.007809747504403995,3,1.5849625007211563
ignored,1,0,2,0.0075161479741632405,3,1.5849625007211563
juvenile,2,0,0,-0.015443335290663537,2,1.0
troll,1,0,0,-0.007751027598355844,1,0.0
unsaid,1,0,0,-0.007751027598355844,1,0.0
stereotype,2,0,1,-0.007809747504403995,3,1.5849625007211563
omitted,1,0,0,-0.007751027598355844,1,0.0
apple,1,0,0,-0.007751027598355844,1,0.0
cart,1,0,0,-0.007751027598355844,1,0.0
upset,1,0,0,-0.007751027598355844,1,0.0
clichéd,5,0,0,-0.038520258367586616,5,2.321928094887362
overshadows,1,0,0,-0.007751027598355844,1,0.0
supposed,12,0,0,-0.09236641221374046,12,3.5849625007211565
conceived,3,0,0,-0.02313564298297123,3,1.5849625007211563
ill,6,0,0,-0.04621256605989431,6,2.584962500721156
astonishing,1,0,0,-0.007751027598355844,1,0.0
badness,3,0,0,-0.02313564298297123,3,1.5849625007211563
awfulness,2,0,0,-0.015443335290663537,2,1.0
summary,1,0,1,-0.0001174398120963021,2,1.0
ces,1,0,0,-0.007751027598355844,1,0.0
perfervid,1,0,0,-0.007751027598355844,1,0.0
warfare,1,0,1,-0.0001174398120963021,2,1.0
juliet,1,0,0,-0.007751027598355844,1,0.0
treads,2,0,1,-0.007809747504403995,3,1.5849625007211563
romeo,1,0,0,-0.007751027598355844,1,0.0
inflict,1,0,0,-0.007751027598355844,1,0.0
reputations,1,0,0,-0.007751027598355844,1,0.0
modem,1,0,0,-0.007751027598355844,1,0.0
28k,1,0,0,-0.007751027598355844,1,0.0
fisticuffs,1,0,1,-0.0001174398120963021,2,1.0
rumbles,1,0,0,-0.007751027598355844,1,0.0
streamed,1,0,0,-0.007751027598355844,1,0.0
smoke,1,0,1,-0.0001174398120963021,2,1.0
cigarette,1,0,0,-0.007751027598355844,1,0.0
paean,2,0,0,-0.015443335290663537,2,1.0
circa,1,0,0,-0.007751027598355844,1,0.0
melodramatic,5,0,3,-0.01561949500880799,8,3.0
1958,2,0,0,-0.015443335290663537,2,1.0
preposterously,1,0,0,-0.007751027598355844,1,0.0
flagrantly,1,0,0,-0.007751027598355844,1,0.0
thunderstorms,1,0,0,-0.007751027598355844,1,0.0
excite,1,0,1,-0.0001174398120963021,2,1.0
fake,2,0,3,0.0074574280681150885,5,2.321928094887362
insecure,1,0,0,-0.007751027598355844,1,0.0
capacity,2,0,1,-0.007809747504403995,3,1.5849625007211563
churns,1,0,0,-0.007751027598355844,1,0.0
editing,6,0,1,-0.03857897827363477,7,2.807354922057604
borders,2,0,1,-0.007809747504403995,3,1.5849625007211563
eroticism,1,0,0,-0.007751027598355844,1,0.0
brainless,2,0,0,-0.015443335290663537,2,1.0
machismo,3,0,2,-0.007868467410452145,5,2.321928094887362
enjoyably,1,0,3,0.015149735760422781,4,2.0
fifties,1,0,0,-0.007751027598355844,1,0.0
homo,1,0,1,-0.0001174398120963021,2,1.0
farewell,1,0,0,-0.007751027598355844,1,0.0
encyclopedia,1,0,0,-0.007751027598355844,1,0.0
shoplifts,1,0,0,-0.007751027598355844,1,0.0
wanderers,1,0,0,-0.007751027598355844,1,0.0
cribbing,1,0,0,-0.007751027598355844,1,0.0
dust,1,0,1,-0.0001174398120963021,2,1.0
gathering,1,0,0,-0.007751027598355844,1,0.0
mgm,2,0,0,-0.015443335290663537,2,1.0
propelled,1,0,0,-0.007751027598355844,1,0.0
caricatures,1,0,0,-0.007751027598355844,1,0.0
turf,1,0,0,-0.007751027598355844,1,0.0
woefully,1,0,0,-0.007751027598355844,1,0.0
empty,7,0,1,-0.04627128596594246,8,3.0
abundant,1,0,0,-0.007751027598355844,1,0.0
gangs,3,0,10,0.05320023487962419,13,3.700439718141092
greatness,0,0,3,0.022842043452730474,3,1.5849625007211563
drastic,0,0,1,0.007574867880211391,1,0.0
hue,0,0,1,0.007574867880211391,1,0.0
iconography,0,0,1,0.007574867880211391,1,0.0
outing,1,0,2,0.0075161479741632405,3,1.5849625007211563
stamina,1,0,2,0.0075161479741632405,3,1.5849625007211563
20th,0,0,4,0.03047563123899002,4,2.0
suck,0,0,3,0.022842043452730474,3,1.5849625007211563
joyless,4,0,0,-0.030827950675278923,4,2.0
passably,2,0,0,-0.015443335290663537,2,1.0
edgiest,0,0,1,0.007574867880211391,1,0.0
brosnan,2,0,9,0.053258954785672344,11,3.4594316186372978
meanest,0,0,2,0.015208455666470933,2,1.0
fastest,0,0,1,0.007574867880211391,1,0.0
cadences,0,0,1,0.007574867880211391,1,0.0
dilutes,1,0,1,-0.0001174398120963021,2,1.0
shortage,0,0,1,0.007574867880211391,1,0.0
thunderous,0,0,1,0.007574867880211391,1,0.0
potency,1,0,1,-0.0001174398120963021,2,1.0
megalomaniac,0,0,1,0.007574867880211391,1,0.0
bent,0,0,1,0.007574867880211391,1,0.0
suspension,1,0,1,-0.0001174398120963021,2,1.0
superfluousepilogue,0,0,1,0.007574867880211391,1,0.0
sieve,0,0,1,0.007574867880211391,1,0.0
raising,2,0,1,-0.007809747504403995,3,1.5849625007211563
halle,0,0,1,0.007574867880211391,1,0.0
feral,0,0,2,0.015208455666470933,2,1.0
emerges,3,0,3,-0.0002348796241926042,6,2.584962500721156
bonds,0,0,3,0.022842043452730474,3,1.5849625007211563
fleming,2,0,0,-0.015443335290663537,2,1.0
garnish,1,0,0,-0.007751027598355844,1,0.0
cocktail,2,0,1,-0.007809747504403995,3,1.5849625007211563
bunch,3,0,2,-0.007868467410452145,5,2.321928094887362
olives,1,0,0,-0.007751027598355844,1,0.0
overused,1,0,1,-0.0001174398120963021,2,1.0
aging,0,0,1,0.007574867880211391,1,0.0
bodied,0,0,1,0.007574867880211391,1,0.0
reinvented,0,0,1,0.007574867880211391,1,0.0
respectful,1,0,2,0.0075161479741632405,3,1.5849625007211563
phenomenon,0,0,1,0.007574867880211391,1,0.0
abundantly,0,0,1,0.007574867880211391,1,0.0
thrilling,3,0,7,0.030299471520845563,10,3.3219280948873626
cabeza,0,0,1,0.007574867880211391,1,0.0
duda,0,0,1,0.007574867880211391,1,0.0
cinta,1,0,1,-0.0001174398120963021,2,1.0
cabe,0,0,1,0.007574867880211391,1,0.0
mejor,0,0,3,0.022842043452730474,3,1.5849625007211563
entretiene,0,0,1,0.007574867880211391,1,0.0
serie,0,0,1,0.007574867880211391,1,0.0
reliance,2,0,1,-0.007809747504403995,3,1.5849625007211563
outings,0,0,1,0.007574867880211391,1,0.0
creep,0,0,2,0.015208455666470933,2,1.0
cartoonlike,0,0,1,0.007574867880211391,1,0.0
cgi,3,0,4,0.00739870816206694,7,2.807354922057604
007,2,0,1,-0.007809747504403995,3,1.5849625007211563
tunnel,2,0,0,-0.015443335290663537,2,1.0
cartoons,3,0,2,-0.007868467410452145,5,2.321928094887362
rudimentary,1,0,1,-0.0001174398120963021,2,1.0
monty,0,0,3,0.022842043452730474,3,1.5849625007211563
python,0,0,2,0.015208455666470933,2,1.0
gilliam,0,0,1,0.007574867880211391,1,0.0
photographs,0,0,1,0.007574867880211391,1,0.0
drawings,1,0,1,-0.0001174398120963021,2,1.0
doddering,1,0,0,-0.007751027598355844,1,0.0
misogynistic,1,0,0,-0.007751027598355844,1,0.0
deriding,1,0,0,-0.007751027598355844,1,0.0
pantheon,3,0,1,-0.015502055196711688,4,2.0
aficionados,1,0,3,0.015149735760422781,4,2.0
anniversary,0,0,1,0.007574867880211391,1,0.0
offs,0,0,1,0.007574867880211391,1,0.0
winding,1,0,0,-0.007751027598355844,1,0.0
temerity,1,0,0,-0.007751027598355844,1,0.0
toilet,3,0,0,-0.02313564298297123,3,1.5849625007211563
stupefying,2,0,0,-0.015443335290663537,2,1.0
bangs,1,0,1,-0.0001174398120963021,2,1.0
feed,2,0,0,-0.015443335290663537,2,1.0
flashes,1,0,2,0.0075161479741632405,3,1.5849625007211563
racing,1,0,1,-0.0001174398120963021,2,1.0
workout,1,0,0,-0.007751027598355844,1,0.0
endured,1,0,0,-0.007751027598355844,1,0.0
stench,1,0,0,-0.007751027598355844,1,0.0
grew,2,0,2,-0.00017615971814445228,4,2.0
charms,3,0,1,-0.015502055196711688,4,2.0
sucker,2,0,1,-0.007809747504403995,3,1.5849625007211563
glamour,1,0,0,-0.007751027598355844,1,0.0
clamor,1,0,0,-0.007751027598355844,1,0.0
paying,2,0,0,-0.015443335290663537,2,1.0
punishment,2,0,0,-0.015443335290663537,2,1.0
goodman,0,0,1,0.007574867880211391,1,0.0
demonstrates,1,0,3,0.015149735760422781,4,2.0
caesar,1,0,2,0.0075161479741632405,3,1.5849625007211563
ritchie,6,0,0,-0.04621256605989431,6,2.584962500721156
aussie,1,0,0,-0.007751027598355844,1,0.0
channels,1,0,1,-0.0001174398120963021,2,1.0
pleasures,1,0,4,0.022783323546682326,5,2.321928094887362
flavour,0,0,1,0.007574867880211391,1,0.0
pizza,0,0,1,0.007574867880211391,1,0.0
ladles,0,0,1,0.007574867880211391,1,0.0
clashing,0,0,1,0.007574867880211391,1,0.0
acclaim,0,0,1,0.007574867880211391,1,0.0
stepped,0,0,1,0.007574867880211391,1,0.0
assurance,0,0,3,0.022842043452730474,3,1.5849625007211563
tool,0,0,1,0.007574867880211391,1,0.0
juiced,0,0,1,0.007574867880211391,1,0.0
callie,1,0,0,-0.007751027598355844,1,0.0
arthritic,1,0,0,-0.007751027598355844,1,0.0
khouri,1,0,2,0.0075161479741632405,3,1.5849625007211563
automobile,0,0,1,0.007574867880211391,1,0.0
sputters,0,0,1,0.007574867880211391,1,0.0
crack,0,0,1,0.007574867880211391,1,0.0
gasp,1,0,3,0.015149735760422781,4,2.0
deportment,0,0,1,0.007574867880211391,1,0.0
o2,0,0,1,0.007574867880211391,1,0.0
maggie,1,0,4,0.022783323546682326,5,2.321928094887362
defiantly,0,0,3,0.022842043452730474,3,1.5849625007211563
divine,2,0,6,0.030358191426893714,8,3.0
mocking,0,0,1,0.007574867880211391,1,0.0
adored,0,0,1,0.007574867880211391,1,0.0
oprah,1,0,0,-0.007751027598355844,1,0.0
lotta,1,0,0,-0.007751027598355844,1,0.0
chicken,1,0,1,-0.0001174398120963021,2,1.0
fried,1,0,0,-0.007751027598355844,1,0.0
yell,0,0,1,0.007574867880211391,1,0.0
novels,0,0,2,0.015208455666470933,2,1.0
essence,2,0,3,0.0074574280681150885,5,2.321928094887362
translating,0,0,1,0.007574867880211391,1,0.0
paper,6,0,1,-0.03857897827363477,7,2.807354922057604
wraps,1,0,0,-0.007751027598355844,1,0.0
recycled,3,0,0,-0.02313564298297123,3,1.5849625007211563
shiny,1,0,0,-0.007751027598355844,1,0.0
bonding,1,0,0,-0.007751027598355844,1,0.0
dishonest,1,0,0,-0.007751027598355844,1,0.0
gentility,0,0,1,0.007574867880211391,1,0.0
skeletons,0,0,1,0.007574867880211391,1,0.0
tempered,0,0,1,0.007574867880211391,1,0.0
shrill,1,0,1,-0.0001174398120963021,2,1.0
errs,0,0,1,0.007574867880211391,1,0.0
soft,3,0,3,-0.0002348796241926042,6,2.584962500721156
heartstrings,1,0,0,-0.007751027598355844,1,0.0
treat,2,0,5,0.022724603640634174,7,2.807354922057604
yas,0,0,2,0.015208455666470933,2,1.0
redeems,0,0,2,0.015208455666470933,2,1.0
flashback,0,0,1,0.007574867880211391,1,0.0
excesses,2,0,0,-0.015443335290663537,2,1.0
flaunts,1,0,0,-0.007751027598355844,1,0.0
fires,1,0,1,-0.0001174398120963021,2,1.0
vivi,1,0,0,-0.007751027598355844,1,0.0
central,3,0,2,-0.007868467410452145,5,2.321928094887362
presumes,0,0,1,0.007574867880211391,1,0.0
backs,0,0,1,0.007574867880211391,1,0.0
precious,5,0,1,-0.030886670581327075,6,2.584962500721156
premises,1,0,1,-0.0001174398120963021,2,1.0
commodity,0,0,1,0.007574867880211391,1,0.0
faithful,1,0,7,0.04568408690546095,8,3.0
fleeting,1,0,2,0.0075161479741632405,3,1.5849625007211563
seamless,0,0,1,0.007574867880211391,1,0.0
amongst,0,0,1,0.007574867880211391,1,0.0
careless,0,0,1,0.007574867880211391,1,0.0
dear,1,0,0,-0.007751027598355844,1,0.0
damn,6,0,1,-0.03857897827363477,7,2.807354922057604
everywhere,1,0,1,-0.0001174398120963021,2,1.0
locate,1,0,0,-0.007751027598355844,1,0.0
tickets,2,0,0,-0.015443335290663537,2,1.0
legitimate,1,0,0,-0.007751027598355844,1,0.0
shred,1,0,0,-0.007751027598355844,1,0.0
plausibility,1,0,0,-0.007751027598355844,1,0.0
pleasantly,0,0,2,0.015208455666470933,2,1.0
dread,1,0,3,0.015149735760422781,4,2.0
wells,0,0,1,0.007574867880211391,1,0.0
seller,1,0,1,-0.0001174398120963021,2,1.0
utter,2,0,3,0.0074574280681150885,5,2.321928094887362
surprised,1,0,4,0.022783323546682326,5,2.321928094887362
rebecca,0,0,1,0.007574867880211391,1,0.0
winningly,0,0,1,0.007574867880211391,1,0.0
assess,1,0,0,-0.007751027598355844,1,0.0
engineering,1,0,0,-0.007751027598355844,1,0.0
afraid,5,0,3,-0.01561949500880799,8,3.0
determine,2,0,0,-0.015443335290663537,2,1.0
wholly,4,0,1,-0.023194362889019382,5,2.321928094887362
histrionics,1,0,0,-0.007751027598355844,1,0.0
nurturing,0,0,1,0.007574867880211391,1,0.0
dithering,0,0,1,0.007574867880211391,1,0.0
gauzy,0,0,1,0.007574867880211391,1,0.0
ploddingly,1,0,1,-0.0001174398120963021,2,1.0
continuum,0,0,1,0.007574867880211391,1,0.0
curdling,0,0,2,0.015208455666470933,2,1.0
farce,1,0,2,0.0075161479741632405,3,1.5849625007211563
squaddie,1,0,0,-0.007751027598355844,1,0.0
shocks,2,0,3,0.0074574280681150885,5,2.321928094887362
goofily,0,0,1,0.007574867880211391,1,0.0
woe,0,0,1,0.007574867880211391,1,0.0
opts,0,0,2,0.015208455666470933,2,1.0
lensed,0,0,1,0.007574867880211391,1,0.0
gorefest,0,0,1,0.007574867880211391,1,0.0
werewolf,3,0,0,-0.02313564298297123,3,1.5849625007211563
develop,2,0,1,-0.007809747504403995,3,1.5849625007211563
grim,2,0,2,-0.00017615971814445228,4,2.0
fest,2,0,1,-0.007809747504403995,3,1.5849625007211563
roaring,0,0,3,0.022842043452730474,3,1.5849625007211563
hairs,0,0,2,0.015208455666470933,2,1.0
crippled,1,0,1,-0.0001174398120963021,2,1.0
amish,1,0,0,-0.007751027598355844,1,0.0
guts,0,0,3,0.022842043452730474,3,1.5849625007211563
freight,0,0,2,0.015208455666470933,2,1.0
neil,0,0,3,0.022842043452730474,3,1.5849625007211563
edited,1,0,4,0.022783323546682326,5,2.321928094887362
bald,0,0,1,0.007574867880211391,1,0.0
rely,1,0,1,-0.0001174398120963021,2,1.0
believer,1,0,0,-0.007751027598355844,1,0.0
gloriously,0,0,2,0.015208455666470933,2,1.0
unsubtle,0,0,1,0.007574867880211391,1,0.0
shockers,0,0,1,0.007574867880211391,1,0.0
adrenalized,0,0,1,0.007574867880211391,1,0.0
encountering,0,0,1,0.007574867880211391,1,0.0
fanboy,0,0,1,0.007574867880211391,1,0.0
howler,1,0,0,-0.007751027598355844,1,0.0
contact,1,0,1,-0.0001174398120963021,2,1.0
avoiding,1,0,0,-0.007751027598355844,1,0.0
pretend,3,0,0,-0.02313564298297123,3,1.5849625007211563
failing,0,0,2,0.015208455666470933,2,1.0
produce,3,0,1,-0.015502055196711688,4,2.0
chomps,0,0,1,0.007574867880211391,1,0.0
transcend,0,0,2,0.015208455666470933,2,1.0
energizes,0,0,1,0.007574867880211391,1,0.0
embraces,0,0,2,0.015208455666470933,2,1.0
welcome,4,0,8,0.030240751614797418,12,3.5849625007211565
pretension,2,0,2,-0.00017615971814445228,4,2.0
shelves,1,0,1,-0.0001174398120963021,2,1.0
gory,1,0,3,0.015149735760422781,4,2.0
dozen,1,0,1,-0.0001174398120963021,2,1.0
symbols,0,0,1,0.007574867880211391,1,0.0
float,0,0,1,0.007574867880211391,1,0.0
sting,1,0,3,0.015149735760422781,4,2.0
bees,0,0,1,0.007574867880211391,1,0.0
styx,0,0,1,0.007574867880211391,1,0.0
concerns,0,0,1,0.007574867880211391,1,0.0
occupied,0,0,1,0.007574867880211391,1,0.0
moviegoers,4,0,3,-0.007927187316500297,7,2.807354922057604
teamwork,0,0,1,0.007574867880211391,1,0.0
invokes,0,0,1,0.007574867880211391,1,0.0
enthusiastically,0,0,1,0.007574867880211391,1,0.0
percussion,0,0,2,0.015208455666470933,2,1.0
bands,1,0,2,0.0075161479741632405,3,1.5849625007211563
halftime,2,0,0,-0.015443335290663537,2,1.0
fifteen,2,0,1,-0.007809747504403995,3,1.5849625007211563
saving,6,0,4,-0.015678214914856138,10,3.3219280948873626
drumming,0,0,2,0.015208455666470933,2,1.0
reaches,1,0,1,-0.0001174398120963021,2,1.0
heroic,1,0,2,0.0075161479741632405,3,1.5849625007211563
irreverent,0,0,1,0.007574867880211391,1,0.0
ably,0,0,1,0.007574867880211391,1,0.0
goodwill,1,0,1,-0.0001174398120963021,2,1.0
crushes,1,0,1,-0.0001174398120963021,2,1.0
resolutions,1,0,0,-0.007751027598355844,1,0.0
graces,0,0,1,0.007574867880211391,1,0.0
cannon,1,0,1,-0.0001174398120963021,2,1.0
routines,1,0,1,-0.0001174398120963021,2,1.0
applies,0,0,1,0.007574867880211391,1,0.0
iii,0,0,1,0.007574867880211391,1,0.0
detail,2,0,7,0.037991779213153255,9,3.1699250014423126
nutty,1,0,0,-0.007751027598355844,1,0.0
geeky,1,0,0,-0.007751027598355844,1,0.0
flags,0,0,1,0.007574867880211391,1,0.0
tuneful,0,0,2,0.015208455666470933,2,1.0
glory,3,0,2,-0.007868467410452145,5,2.321928094887362
compensating,0,0,1,0.007574867880211391,1,0.0
guaranteed,0,0,4,0.03047563123899002,4,2.0
fantastically,0,0,1,0.007574867880211391,1,0.0
coated,1,0,0,-0.007751027598355844,1,0.0
honks,1,0,0,-0.007751027598355844,1,0.0
trombone,1,0,0,-0.007751027598355844,1,0.0
rocky,2,0,1,-0.007809747504403995,3,1.5849625007211563
manhood,0,0,1,0.007574867880211391,1,0.0
vulgarity,1,0,1,-0.0001174398120963021,2,1.0
cussing,0,0,2,0.015208455666470933,2,1.0
spunk,1,0,1,-0.0001174398120963021,2,1.0
drum,1,0,3,0.015149735760422781,4,2.0
groundbreaking,1,0,1,-0.0001174398120963021,2,1.0
insult,2,0,1,-0.007809747504403995,3,1.5849625007211563
dumbed,1,0,1,-0.0001174398120963021,2,1.0
boom,1,0,1,-0.0001174398120963021,2,1.0
collegiate,0,0,1,0.007574867880211391,1,0.0
ka,0,0,1,0.007574867880211391,1,0.0
variation,2,0,2,-0.00017615971814445228,4,2.0
holiday,2,0,4,0.015091015854374633,6,2.584962500721156
quotient,0,0,2,0.015208455666470933,2,1.0
superlative,0,0,1,0.007574867880211391,1,0.0
suggestion,1,0,0,-0.007751027598355844,1,0.0
fully,5,0,3,-0.01561949500880799,8,3.0
albeit,2,0,3,0.0074574280681150885,5,2.321928094887362
realized,4,0,1,-0.023194362889019382,5,2.321928094887362
exhilarating,1,0,6,0.03805049911920141,7,2.807354922057604
tremors,1,0,3,0.015149735760422781,4,2.0
screaming,3,0,1,-0.015502055196711688,4,2.0
chemicals,0,0,1,0.007574867880211391,1,0.0
creatures,0,0,2,0.015208455666470933,2,1.0
chomp,0,0,3,0.022842043452730474,3,1.5849625007211563
bought,0,0,1,0.007574867880211391,1,0.0
freaks,6,0,5,-0.008044627128596597,11,3.4594316186372978
rated,2,0,2,-0.00017615971814445228,4,2.0
threatening,1,0,1,-0.0001174398120963021,2,1.0
befits,1,0,0,-0.007751027598355844,1,0.0
softener,1,0,0,-0.007751027598355844,1,0.0
piffle,5,0,0,-0.038520258367586616,5,2.321928094887362
snuggle,1,0,0,-0.007751027598355844,1,0.0
pg,1,0,1,-0.0001174398120963021,2,1.0
agreeably,0,0,2,0.015208455666470933,2,1.0
ninety,1,0,1,-0.0001174398120963021,2,1.0
hybrids,1,0,0,-0.007751027598355844,1,0.0
nudge,2,0,0,-0.015443335290663537,2,1.0
hairy,1,0,0,-0.007751027598355844,1,0.0
arquette,1,0,0,-0.007751027598355844,1,0.0
affability,2,0,0,-0.015443335290663537,2,1.0
nominal,1,0,0,-0.007751027598355844,1,0.0
escapist,0,0,5,0.03810921902524956,5,2.321928094887362
cheesy,6,0,0,-0.04621256605989431,6,2.584962500721156
polite,1,0,0,-0.007751027598355844,1,0.0
styled,1,0,0,-0.007751027598355844,1,0.0
gremlins,1,0,0,-0.007751027598355844,1,0.0
similarly,1,0,2,0.0075161479741632405,3,1.5849625007211563
leash,2,0,0,-0.015443335290663537,2,1.0
acknowledges,0,0,2,0.015208455666470933,2,1.0
cheesiness,0,0,1,0.007574867880211391,1,0.0
50,4,0,1,-0.023194362889019382,5,2.321928094887362
emphatic,0,0,1,0.007574867880211391,1,0.0
declarations,0,0,1,0.007574867880211391,1,0.0
ripe,3,0,2,-0.007868467410452145,5,2.321928094887362
cocoon,1,0,1,-0.0001174398120963021,2,1.0
motorcycle,1,0,0,-0.007751027598355844,1,0.0
outrun,1,0,0,-0.007751027598355844,1,0.0
comprehension,0,0,1,0.007574867880211391,1,0.0
busy,4,0,1,-0.023194362889019382,5,2.321928094887362
ribbing,1,0,0,-0.007751027598355844,1,0.0
clunky,3,0,1,-0.015502055196711688,4,2.0
messing,1,0,1,-0.0001174398120963021,2,1.0
bug,2,0,1,-0.007809747504403995,3,1.5849625007211563
formulas,0,0,2,0.015208455666470933,2,1.0
unqualified,1,0,0,-0.007751027598355844,1,0.0
recommendation,1,0,1,-0.0001174398120963021,2,1.0
beaut,0,0,1,0.007574867880211391,1,0.0
starship,1,0,0,-0.007751027598355844,1,0.0
partly,2,0,2,-0.00017615971814445228,4,2.0
sophomoric,1,0,1,-0.0001174398120963021,2,1.0
tarantula,0,0,2,0.015208455666470933,2,1.0
1950s,0,0,3,0.022842043452730474,3,1.5849625007211563
conditions,0,0,2,0.015208455666470933,2,1.0
hellish,0,0,1,0.007574867880211391,1,0.0
trailer,3,0,1,-0.015502055196711688,4,2.0
invasion,0,0,2,0.015208455666470933,2,1.0
menu,0,0,1,0.007574867880211391,1,0.0
include,3,0,0,-0.02313564298297123,3,1.5849625007211563
bothered,1,0,0,-0.007751027598355844,1,0.0
muddled,1,0,0,-0.007751027598355844,1,0.0
hispanic,1,0,1,-0.0001174398120963021,2,1.0
americans,3,0,3,-0.0002348796241926042,6,2.584962500721156
tarted,1,0,0,-0.007751027598355844,1,0.0
flava,1,0,0,-0.007751027598355844,1,0.0
playas,1,0,0,-0.007751027598355844,1,0.0
empire,2,0,4,0.015091015854374633,6,2.584962500721156
heartedness,0,0,1,0.007574867880211391,1,0.0
focuses,0,0,3,0.022842043452730474,3,1.5849625007211563
refined,1,0,0,-0.007751027598355844,1,0.0
dramas,4,0,2,-0.015560775102759838,6,2.584962500721156
coat,1,0,0,-0.007751027598355844,1,0.0
heartless,1,0,0,-0.007751027598355844,1,0.0
latino,2,0,0,-0.015443335290663537,2,1.0
repackaged,2,0,0,-0.015443335290663537,2,1.0
carbon,1,0,0,-0.007751027598355844,1,0.0
jackets,1,0,0,-0.007751027598355844,1,0.0
trod,0,0,1,0.007574867880211391,1,0.0
21st,1,0,1,-0.0001174398120963021,2,1.0
quickie,1,0,1,-0.0001174398120963021,2,1.0
franc,1,0,0,-0.007751027598355844,1,0.0
reyes,2,0,0,-0.015443335290663537,2,1.0
processor,2,0,0,-0.015443335290663537,2,1.0
5ths,1,0,0,-0.007751027598355844,1,0.0
possessed,1,0,0,-0.007751027598355844,1,0.0
adds,3,0,3,-0.0002348796241926042,6,2.584962500721156
undone,3,0,0,-0.02313564298297123,3,1.5849625007211563
sloppy,5,0,1,-0.030886670581327075,6,2.584962500721156
rehash,2,0,0,-0.015443335290663537,2,1.0
internalized,0,0,1,0.007574867880211391,1,0.0
intimate,1,0,5,0.030416911332941866,6,2.584962500721156
rackets,1,0,0,-0.007751027598355844,1,0.0
retold,1,0,0,-0.007751027598355844,1,0.0
searches,2,0,0,-0.015443335290663537,2,1.0
vainly,1,0,0,-0.007751027598355844,1,0.0
trusting,1,0,1,-0.0001174398120963021,2,1.0
zest,1,0,0,-0.007751027598355844,1,0.0
carlito,1,0,0,-0.007751027598355844,1,0.0
scarface,1,0,0,-0.007751027598355844,1,0.0
capitalism,0,0,1,0.007574867880211391,1,0.0
critique,1,0,2,0.0075161479741632405,3,1.5849625007211563
bursts,1,0,1,-0.0001174398120963021,2,1.0
gunfire,1,0,1,-0.0001174398120963021,2,1.0
trenchant,0,0,2,0.015208455666470933,2,1.0
genres,2,0,3,0.0074574280681150885,5,2.321928094887362
radical,2,0,0,-0.015443335290663537,2,1.0
personalities,2,0,0,-0.015443335290663537,2,1.0
plumbed,1,0,0,-0.007751027598355844,1,0.0
describe,4,0,1,-0.023194362889019382,5,2.321928094887362
plugged,1,0,0,-0.007751027598355844,1,0.0
thank,3,0,0,-0.02313564298297123,3,1.5849625007211563
shouted,1,0,0,-0.007751027598355844,1,0.0
extemporaneously,1,0,0,-0.007751027598355844,1,0.0
treating,1,0,0,-0.007751027598355844,1,0.0
prop,2,0,0,-0.015443335290663537,2,1.0
thrills,8,0,4,-0.031062830299471524,12,3.5849625007211565
jeopardy,2,0,0,-0.015443335290663537,2,1.0
disgusting,3,0,1,-0.015502055196711688,4,2.0
overstated,1,0,0,-0.007751027598355844,1,0.0
flopped,1,0,0,-0.007751027598355844,1,0.0
soufflé,1,0,0,-0.007751027598355844,1,0.0
pounding,1,0,0,-0.007751027598355844,1,0.0
wrapped,1,0,2,0.0075161479741632405,3,1.5849625007211563
tense,1,0,3,0.015149735760422781,4,2.0
lo,4,0,3,-0.007927187316500297,7,2.807354922057604
spousal,3,0,0,-0.02313564298297123,3,1.5849625007211563
pander,0,0,1,0.007574867880211391,1,0.0
desires,0,0,1,0.007574867880211391,1,0.0
basest,0,0,1,0.007574867880211391,1,0.0
jump,2,0,0,-0.015443335290663537,2,1.0
mad,1,0,1,-0.0001174398120963021,2,1.0
inept,9,0,0,-0.06928948913681739,9,3.1699250014423126
libs,1,0,0,-0.007751027598355844,1,0.0
hilariously,1,0,0,-0.007751027598355844,1,0.0
junk,5,0,0,-0.038520258367586616,5,2.321928094887362
nymphette,1,0,0,-0.007751027598355844,1,0.0
slim,2,0,0,-0.015443335290663537,2,1.0
sell,3,0,0,-0.02313564298297123,3,1.5849625007211563
lewis,1,0,6,0.03805049911920141,7,2.807354922057604
incognito,1,0,0,-0.007751027598355844,1,0.0
costume,2,0,0,-0.015443335290663537,2,1.0
mommy,1,0,0,-0.007751027598355844,1,0.0
wig,1,0,0,-0.007751027598355844,1,0.0
minnie,1,0,0,-0.007751027598355844,1,0.0
juliette,1,0,0,-0.007751027598355844,1,0.0
crassness,1,0,0,-0.007751027598355844,1,0.0
ridiculousness,2,0,1,-0.007809747504403995,3,1.5849625007211563
preposterous,6,0,2,-0.030945390487375223,8,3.0
resemblance,2,0,0,-0.015443335290663537,2,1.0
battered,2,0,1,-0.007809747504403995,3,1.5849625007211563
fighters,1,0,0,-0.007751027598355844,1,0.0
picked,3,0,0,-0.02313564298297123,3,1.5849625007211563
lock,2,0,0,-0.015443335290663537,2,1.0
sensationalistic,1,0,0,-0.007751027598355844,1,0.0
grossly,2,0,0,-0.015443335290663537,2,1.0
unrealistic,1,0,0,-0.007751027598355844,1,0.0
pent,0,0,1,0.007574867880211391,1,0.0
feminist,4,0,0,-0.030827950675278923,4,2.0
thinly,3,0,0,-0.02313564298297123,3,1.5849625007211563
roman,1,0,0,-0.007751027598355844,1,0.0
colosseum,1,0,0,-0.007751027598355844,1,0.0
florid,3,0,0,-0.02313564298297123,3,1.5849625007211563
reduces,4,0,0,-0.030827950675278923,4,2.0
kazan,1,0,0,-0.007751027598355844,1,0.0
reversal,2,0,0,-0.015443335290663537,2,1.0
apted,1,0,0,-0.007751027598355844,1,0.0
enigma,1,0,0,-0.007751027598355844,1,0.0
cohesion,1,0,0,-0.007751027598355844,1,0.0
airhead,2,0,0,-0.015443335290663537,2,1.0
zillionth,1,0,0,-0.007751027598355844,1,0.0
resorts,1,0,0,-0.007751027598355844,1,0.0
distress,2,0,0,-0.015443335290663537,2,1.0
measures,1,0,0,-0.007751027598355844,1,0.0
ga,1,0,0,-0.007751027598355844,1,0.0
drenched,1,0,0,-0.007751027598355844,1,0.0
loathsome,1,0,0,-0.007751027598355844,1,0.0
crisis,2,0,1,-0.007809747504403995,3,1.5849625007211563
trivializes,2,0,0,-0.015443335290663537,2,1.0
damsel,1,0,0,-0.007751027598355844,1,0.0
overdone,1,0,0,-0.007751027598355844,1,0.0
affluent,2,0,0,-0.015443335290663537,2,1.0
bully,1,0,0,-0.007751027598355844,1,0.0
unoriginal,4,0,3,-0.007927187316500297,7,2.807354922057604
color,1,0,3,0.015149735760422781,4,2.0
preachy,6,0,2,-0.030945390487375223,8,3.0
woo,10,0,4,-0.04644744568408691,14,3.8073549220576037
parable,4,0,0,-0.030827950675278923,4,2.0
ballet,1,0,0,-0.007751027598355844,1,0.0
pervasive,1,0,0,-0.007751027598355844,1,0.0
somnambulant,1,0,0,-0.007751027598355844,1,0.0
wachowski,1,0,0,-0.007751027598355844,1,0.0
lucas,2,0,3,0.0074574280681150885,5,2.321928094887362
kafka,2,0,1,-0.007809747504403995,3,1.5849625007211563
blender,1,0,0,-0.007751027598355844,1,0.0
bradbury,1,0,0,-0.007751027598355844,1,0.0
ingredients,2,0,1,-0.007809747504403995,3,1.5849625007211563
orwell,3,0,1,-0.015502055196711688,4,2.0
threw,3,0,0,-0.02313564298297123,3,1.5849625007211563
chemists,0,0,1,0.007574867880211391,1,0.0
equilibrium,5,0,1,-0.030886670581327075,6,2.584962500721156
1949,0,0,1,0.007574867880211391,1,0.0
envisioned,0,0,1,0.007574867880211391,1,0.0
imagined,0,0,2,0.015208455666470933,2,1.0
kurt,1,0,0,-0.007751027598355844,1,0.0
wimmer,1,0,0,-0.007751027598355844,1,0.0
fahrenheit,1,0,0,-0.007751027598355844,1,0.0
retooling,1,0,0,-0.007751027598355844,1,0.0
matrix,2,0,0,-0.015443335290663537,2,1.0
451,2,0,0,-0.015443335290663537,2,1.0
dystopian,1,0,0,-0.007751027598355844,1,0.0
ridicule,2,0,0,-0.015443335290663537,2,1.0
sidesplitting,1,0,1,-0.0001174398120963021,2,1.0
graffiti,1,0,0,-0.007751027598355844,1,0.0
bridge,1,0,0,-0.007751027598355844,1,0.0
fu,1,0,0,-0.007751027598355844,1,0.0
overshadowed,1,0,1,-0.0001174398120963021,2,1.0
clericks,1,0,0,-0.007751027598355844,1,0.0
kung,1,0,0,-0.007751027598355844,1,0.0
uberviolence,1,0,0,-0.007751027598355844,1,0.0
advanced,1,0,0,-0.007751027598355844,1,0.0
rampantly,1,0,0,-0.007751027598355844,1,0.0
prozac,1,0,0,-0.007751027598355844,1,0.0
doofus,3,0,1,-0.015502055196711688,4,2.0
insanely,2,0,1,-0.007809747504403995,3,1.5849625007211563
deleting,1,0,0,-0.007751027598355844,1,0.0
1984,2,0,1,-0.007809747504403995,3,1.5849625007211563
thirteen,1,0,0,-0.007751027598355844,1,0.0
totalitarian,1,0,1,-0.0001174398120963021,2,1.0
equlibrium,1,0,0,-0.007751027598355844,1,0.0
farenheit,1,0,0,-0.007751027598355844,1,0.0
highs,1,0,1,-0.0001174398120963021,2,1.0
lows,1,0,1,-0.0001174398120963021,2,1.0
philosophy,2,0,0,-0.015443335290663537,2,1.0
massacres,1,0,0,-0.007751027598355844,1,0.0
balancing,1,0,1,-0.0001174398120963021,2,1.0
throughoutbut,1,0,0,-0.007751027598355844,1,0.0
dumbness,2,0,0,-0.015443335290663537,2,1.0
holding,1,0,0,-0.007751027598355844,1,0.0
distract,1,0,0,-0.007751027598355844,1,0.0
whirling,1,0,0,-0.007751027598355844,1,0.0
gadgets,2,0,1,-0.007809747504403995,3,1.5849625007211563
practically,2,0,1,-0.007809747504403995,3,1.5849625007211563
stud,1,0,0,-0.007751027598355844,1,0.0
affectation,1,0,0,-0.007751027598355844,1,0.0
knockabout,1,0,0,-0.007751027598355844,1,0.0
stripped,1,0,1,-0.0001174398120963021,2,1.0
inspirations,1,0,0,-0.007751027598355844,1,0.0
pastiche,2,0,1,-0.007809747504403995,3,1.5849625007211563
stylishness,0,0,2,0.015208455666470933,2,1.0
sf,0,0,1,0.007574867880211391,1,0.0
statement,2,0,2,-0.00017615971814445228,4,2.0
combos,0,0,1,0.007574867880211391,1,0.0
illiterate,1,0,0,-0.007751027598355844,1,0.0
inert,1,0,0,-0.007751027598355844,1,0.0
giggling,0,0,1,0.007574867880211391,1,0.0
inconsistencies,1,0,1,-0.0001174398120963021,2,1.0
unsophisticated,2,0,0,-0.015443335290663537,2,1.0
deja,5,0,1,-0.030886670581327075,6,2.584962500721156
literary,1,0,3,0.015149735760422781,4,2.0
vu,4,0,1,-0.023194362889019382,5,2.321928094887362
opposed,1,0,1,-0.0001174398120963021,2,1.0
manifesto,1,0,0,-0.007751027598355844,1,0.0
curiously,1,0,3,0.015149735760422781,4,2.0
beresford,0,0,1,0.007574867880211391,1,0.0
mixes,1,0,1,-0.0001174398120963021,2,1.0
nicely,1,0,5,0.030416911332941866,6,2.584962500721156
embrace,0,0,2,0.015208455666470933,2,1.0
stereotypes,4,0,3,-0.007927187316500297,7,2.807354922057604
bondish,1,0,0,-0.007751027598355844,1,0.0
strenuously,2,0,1,-0.007809747504403995,3,1.5849625007211563
modesty,0,0,1,0.007574867880211391,1,0.0
brogueaccentuating,1,0,0,-0.007751027598355844,1,0.0
saccharine,4,0,1,-0.023194362889019382,5,2.321928094887362
muting,1,0,0,-0.007751027598355844,1,0.0
tearjerker,2,0,1,-0.007809747504403995,3,1.5849625007211563
besotted,2,0,0,-0.015443335290663537,2,1.0
descriptions,1,0,0,-0.007751027598355844,1,0.0
blarney,1,0,0,-0.007751027598355844,1,0.0
claptrap,2,0,0,-0.015443335290663537,2,1.0
cardiac,1,0,0,-0.007751027598355844,1,0.0
doses,1,0,4,0.022783323546682326,5,2.321928094887362
unabashedly,0,0,3,0.022842043452730474,3,1.5849625007211563
schmaltzy,1,0,2,0.0075161479741632405,3,1.5849625007211563
sugary,2,0,0,-0.015443335290663537,2,1.0
overloads,1,0,0,-0.007751027598355844,1,0.0
pender,2,0,0,-0.015443335290663537,2,1.0
oppositions,1,0,0,-0.007751027598355844,1,0.0
stacked,1,0,0,-0.007751027598355844,1,0.0
stagy,1,0,0,-0.007751027598355844,1,0.0
binary,1,0,0,-0.007751027598355844,1,0.0
persuades,1,0,0,-0.007751027598355844,1,0.0
changed,1,0,1,-0.0001174398120963021,2,1.0
meanies,0,0,1,0.007574867880211391,1,0.0
separates,0,0,1,0.007574867880211391,1,0.0
defeated,1,0,1,-0.0001174398120963021,2,1.0
affected,1,0,0,-0.007751027598355844,1,0.0
esque,2,0,1,-0.007809747504403995,3,1.5849625007211563
dullest,3,0,0,-0.02313564298297123,3,1.5849625007211563
aspects,1,0,3,0.015149735760422781,4,2.0
pub,1,0,0,-0.007751027598355844,1,0.0
permeates,1,0,1,-0.0001174398120963021,2,1.0
proficiently,0,0,1,0.007574867880211391,1,0.0
trounce,0,0,1,0.007574867880211391,1,0.0
historic,0,0,1,0.007574867880211391,1,0.0
raise,1,0,2,0.0075161479741632405,3,1.5849625007211563
disguise,2,0,0,-0.015443335290663537,2,1.0
animation,10,0,9,-0.008279506752789198,19,4.247927513443585
relying,2,0,1,-0.007809747504403995,3,1.5849625007211563
weightless,1,0,1,-0.0001174398120963021,2,1.0
torture,1,0,1,-0.0001174398120963021,2,1.0
sung,0,0,1,0.007574867880211391,1,0.0
carol,1,0,2,0.0075161479741632405,3,1.5849625007211563
stirs,0,0,1,0.007574867880211391,1,0.0
peeved,0,0,1,0.007574867880211391,1,0.0
nail,0,0,2,0.015208455666470933,2,1.0
verbally,1,0,0,-0.007751027598355844,1,0.0
flatfooted,1,0,0,-0.007751027598355844,1,0.0
aidan,0,0,1,0.007574867880211391,1,0.0
lolling,0,0,1,0.007574867880211391,1,0.0
rea,0,0,1,0.007574867880211391,1,0.0
quartet,0,0,1,0.007574867880211391,1,0.0
grandiloquent,0,0,1,0.007574867880211391,1,0.0
eagles,0,0,1,0.007574867880211391,1,0.0
settings,0,0,1,0.007574867880211391,1,0.0
tis,0,0,1,0.007574867880211391,1,0.0
sincerely,0,0,1,0.007574867880211391,1,0.0
jam,0,0,2,0.015208455666470933,2,1.0
traditional,2,0,3,0.0074574280681150885,5,2.321928094887362
surehanded,0,0,1,0.007574867880211391,1,0.0
cloyingly,1,0,0,-0.007751027598355844,1,0.0
exceeds,0,0,1,0.007574867880211391,1,0.0
bluescreen,2,0,0,-0.015443335290663537,2,1.0
ultra,3,0,2,-0.007868467410452145,5,2.321928094887362
highlight,2,0,1,-0.007809747504403995,3,1.5849625007211563
spell,1,0,7,0.04568408690546095,8,3.0
pickup,1,0,0,-0.007751027598355844,1,0.0
imprint,1,0,0,-0.007751027598355844,1,0.0
european,1,0,0,-0.007751027598355844,1,0.0
basement,1,0,0,-0.007751027598355844,1,0.0
paramount,2,0,0,-0.015443335290663537,2,1.0
bargain,1,0,0,-0.007751027598355844,1,0.0
anybody,3,0,0,-0.02313564298297123,3,1.5849625007211563
cliffhanger,1,0,0,-0.007751027598355844,1,0.0
reworking,2,0,0,-0.015443335290663537,2,1.0
stuntwork,1,0,0,-0.007751027598355844,1,0.0
upstaged,1,0,0,-0.007751027598355844,1,0.0
cheaper,1,0,0,-0.007751027598355844,1,0.0
oatmeal,1,0,0,-0.007751027598355844,1,0.0
eating,2,0,0,-0.015443335290663537,2,1.0
wheezing,2,0,0,-0.015443335290663537,2,1.0
enliven,1,0,0,-0.007751027598355844,1,0.0
boorishness,1,0,0,-0.007751027598355844,1,0.0
protagonists,2,0,2,-0.00017615971814445228,4,2.0
mars,3,0,1,-0.015502055196711688,4,2.0
subplot,1,0,0,-0.007751027598355844,1,0.0
briefly,1,0,0,-0.007751027598355844,1,0.0
inane,5,0,0,-0.038520258367586616,5,2.321928094887362
gave,3,0,1,-0.015502055196711688,4,2.0
invest,2,0,0,-0.015443335290663537,2,1.0
earned,2,0,1,-0.007809747504403995,3,1.5849625007211563
zaidan,2,0,0,-0.015443335290663537,2,1.0
frequently,4,0,4,-0.00029359953024075264,8,3.0
faking,1,0,0,-0.007751027598355844,1,0.0
hawk,4,0,1,-0.023194362889019382,5,2.321928094887362
interspliced,1,0,0,-0.007751027598355844,1,0.0
shore,1,0,0,-0.007751027598355844,1,0.0
skating,1,0,0,-0.007751027598355844,1,0.0
paycheck,1,0,0,-0.007751027598355844,1,0.0
uh,1,0,0,-0.007751027598355844,1,0.0
zeroes,1,0,0,-0.007751027598355844,1,0.0
spout,1,0,0,-0.007751027598355844,1,0.0
icy,2,0,0,-0.015443335290663537,2,1.0
pathetically,1,0,0,-0.007751027598355844,1,0.0
improbable,1,0,2,0.0075161479741632405,3,1.5849625007211563
spittingly,1,0,0,-0.007751027598355844,1,0.0
rub,0,0,1,0.007574867880211391,1,0.0
cells,0,0,1,0.007574867880211391,1,0.0
spit,2,0,1,-0.007809747504403995,3,1.5849625007211563
hoppy,1,0,0,-0.007751027598355844,1,0.0
software,1,0,0,-0.007751027598355844,1,0.0
program,4,0,0,-0.030827950675278923,4,2.0
moldering,1,0,0,-0.007751027598355844,1,0.0
frames,2,0,0,-0.015443335290663537,2,1.0
worthless,1,0,0,-0.007751027598355844,1,0.0
idiocy,3,0,1,-0.015502055196711688,4,2.0
marvel,0,0,4,0.03047563123899002,4,2.0
academic,1,0,2,0.0075161479741632405,3,1.5849625007211563
criticism,2,0,1,-0.007809747504403995,3,1.5849625007211563
haynes,0,0,12,0.09154433352906635,12,3.5849625007211565
subtly,0,0,3,0.022842043452730474,3,1.5849625007211563
june,0,0,1,0.007574867880211391,1,0.0
wyman,0,0,1,0.007574867880211391,1,0.0
underplays,0,0,1,0.007574867880211391,1,0.0
unflappable,0,0,1,0.007574867880211391,1,0.0
dignity,1,0,3,0.015149735760422781,4,2.0
cleaver,0,0,1,0.007574867880211391,1,0.0
sumamente,0,0,1,0.007574867880211391,1,0.0
humana,0,0,1,0.007574867880211391,1,0.0
estupendamente,0,0,1,0.007574867880211391,1,0.0
emotiva,0,0,1,0.007574867880211391,1,0.0
actuada,1,0,1,-0.0001174398120963021,2,1.0
experiencia,0,0,1,0.007574867880211391,1,0.0
fílmica,0,0,1,0.007574867880211391,1,0.0
olvidar,0,0,1,0.007574867880211391,1,0.0
profundamente,0,0,1,0.007574867880211391,1,0.0
imposible,0,0,1,0.007574867880211391,1,0.0
lore,0,0,2,0.015208455666470933,2,1.0
rooted,1,0,2,0.0075161479741632405,3,1.5849625007211563
apes,0,0,1,0.007574867880211391,1,0.0
steeped,1,0,1,-0.0001174398120963021,2,1.0
sociology,1,0,1,-0.0001174398120963021,2,1.0
fiesta,0,0,1,0.007574867880211391,1,0.0
del,2,0,5,0.022724603640634174,7,2.807354922057604
tiempo,2,0,1,-0.007809747504403995,3,1.5849625007211563
movilizador,0,0,1,0.007574867880211391,1,0.0
al,1,0,4,0.022783323546682326,5,2.321928094887362
deseos,0,0,1,0.007574867880211391,1,0.0
oídos,0,0,1,0.007574867880211391,1,0.0
mismo,0,0,1,0.007574867880211391,1,0.0
miedos,0,0,1,0.007574867880211391,1,0.0
enfrentados,0,0,1,0.007574867880211391,1,0.0
prejuicios,0,0,1,0.007574867880211391,1,0.0
ojos,0,0,1,0.007574867880211391,1,0.0
paraíso,0,0,1,0.007574867880211391,1,0.0
para,1,0,2,0.0075161479741632405,3,1.5849625007211563
lejos,0,0,1,0.007574867880211391,1,0.0
cuadro,0,0,1,0.007574867880211391,1,0.0
propios,0,0,1,0.007574867880211391,1,0.0
juggling,0,0,2,0.015208455666470933,2,1.0
absolute,1,0,2,0.0075161479741632405,3,1.5849625007211563
sirk,0,0,2,0.015208455666470933,2,1.0
shimmering,1,0,0,-0.007751027598355844,1,0.0
aptly,1,0,0,-0.007751027598355844,1,0.0
todd,1,0,1,-0.0001174398120963021,2,1.0
limb,1,0,1,-0.0001174398120963021,2,1.0
inches,0,0,1,0.007574867880211391,1,0.0
dismantle,0,0,1,0.007574867880211391,1,0.0
wonderous,0,0,1,0.007574867880211391,1,0.0
construct,0,0,1,0.007574867880211391,1,0.0
facades,0,0,1,0.007574867880211391,1,0.0
veracity,0,0,1,0.007574867880211391,1,0.0
maintain,0,0,2,0.015208455666470933,2,1.0
alluring,0,0,1,0.007574867880211391,1,0.0
suburban,0,0,3,0.022842043452730474,3,1.5849625007211563
constrictive,0,0,1,0.007574867880211391,1,0.0
eisenhower,0,0,1,0.007574867880211391,1,0.0
tranquil,0,0,1,0.007574867880211391,1,0.0
shatters,0,0,1,0.007574867880211391,1,0.0
fetishized,0,0,1,0.007574867880211391,1,0.0
monastic,0,0,1,0.007574867880211391,1,0.0
devotion,0,0,2,0.015208455666470933,2,1.0
fanatically,0,0,1,0.007574867880211391,1,0.0
idiosyncrasy,0,0,1,0.007574867880211391,1,0.0
recreation,1,0,0,-0.007751027598355844,1,0.0
postcard,2,0,0,-0.015443335290663537,2,1.0
pin,2,0,0,-0.015443335290663537,2,1.0
neat,1,0,1,-0.0001174398120963021,2,1.0
devotedly,1,0,0,-0.007751027598355844,1,0.0
discourse,1,0,1,-0.0001174398120963021,2,1.0
unfamiliar,0,0,1,0.007574867880211391,1,0.0
avenues,0,0,1,0.007574867880211391,1,0.0
bernstein,0,0,1,0.007574867880211391,1,0.0
elmer,0,0,1,0.007574867880211391,1,0.0
melodic,0,0,1,0.007574867880211391,1,0.0
calculated,5,0,1,-0.030886670581327075,6,2.584962500721156
purely,1,0,2,0.0075161479741632405,3,1.5849625007211563
irresistible,0,0,3,0.022842043452730474,3,1.5849625007211563
nugget,0,0,1,0.007574867880211391,1,0.0
racial,4,0,3,-0.007927187316500297,7,2.807354922057604
valid,0,0,1,0.007574867880211391,1,0.0
impresses,0,0,2,0.015208455666470933,2,1.0
1995,0,0,1,0.007574867880211391,1,0.0
defies,0,0,3,0.022842043452730474,3,1.5849625007211563
parameters,0,0,1,0.007574867880211391,1,0.0
categorization,0,0,1,0.007574867880211391,1,0.0
1957,0,0,2,0.015208455666470933,2,1.0
irony,1,0,2,0.0075161479741632405,3,1.5849625007211563
racism,0,0,2,0.015208455666470933,2,1.0
homophobia,0,0,1,0.007574867880211391,1,0.0
artificiality,0,0,2,0.015208455666470933,2,1.0
enthralling,0,0,1,0.007574867880211391,1,0.0
conceptual,1,0,2,0.0075161479741632405,3,1.5849625007211563
scored,1,0,1,-0.0001174398120963021,2,1.0
ensnaring,0,0,1,0.007574867880211391,1,0.0
mores,1,0,1,-0.0001174398120963021,2,1.0
rhetoric,0,0,1,0.007574867880211391,1,0.0
differently,0,0,1,0.007574867880211391,1,0.0
transformed,0,0,4,0.03047563123899002,4,2.0
anda,0,0,1,0.007574867880211391,1,0.0
mexican,0,0,3,0.022842043452730474,3,1.5849625007211563
painted,0,0,2,0.015208455666470933,2,1.0
clenching,0,0,1,0.007574867880211391,1,0.0
taymor,1,0,3,0.015149735760422781,4,2.0
catapulting,0,0,1,0.007574867880211391,1,0.0
utilizes,0,0,1,0.007574867880211391,1,0.0
fearlessness,0,0,1,0.007574867880211391,1,0.0
conveys,0,0,1,0.007574867880211391,1,0.0
nonconformist,0,0,1,0.007574867880211391,1,0.0
mexico,0,0,1,0.007574867880211391,1,0.0
captivating,2,0,1,-0.007809747504403995,3,1.5849625007211563
avant,0,0,1,0.007574867880211391,1,0.0
garde,0,0,1,0.007574867880211391,1,0.0
titus,1,0,1,-0.0001174398120963021,2,1.0
lion,0,0,1,0.007574867880211391,1,0.0
exploring,2,0,0,-0.015443335290663537,2,1.0
covering,1,0,0,-0.007751027598355844,1,0.0
versa,0,0,1,0.007574867880211391,1,0.0
suggestive,1,0,1,-0.0001174398120963021,2,1.0
odds,0,0,2,0.015208455666470933,2,1.0
daunting,0,0,2,0.015208455666470933,2,1.0
julie,1,0,1,-0.0001174398120963021,2,1.0
brio,1,0,0,-0.007751027598355844,1,0.0
swallow,2,0,0,-0.015443335290663537,2,1.0
contenido,1,0,0,-0.007751027598355844,1,0.0
preciosista,1,0,0,-0.007751027598355844,1,0.0
versión,1,0,0,-0.007751027598355844,1,0.0
ningún,1,0,0,-0.007751027598355844,1,0.0
paintings,1,0,3,0.015149735760422781,4,2.0
forgiven,2,0,0,-0.015443335290663537,2,1.0
technical,1,0,2,0.0075161479741632405,3,1.5849625007211563
informative,1,0,1,-0.0001174398120963021,2,1.0
stages,1,0,1,-0.0001174398120963021,2,1.0
kahlories,0,0,1,0.007574867880211391,1,0.0
seldom,0,0,1,0.007574867880211391,1,0.0
burns,2,0,1,-0.007809747504403995,3,1.5849625007211563
honorably,0,0,1,0.007574867880211391,1,0.0
hammy,0,0,2,0.015208455666470933,2,1.0
brilliance,2,0,3,0.0074574280681150885,5,2.321928094887362
imaginable,2,0,1,-0.007809747504403995,3,1.5849625007211563
impossibly,0,0,1,0.007574867880211391,1,0.0
sandwiched,0,0,1,0.007574867880211391,1,0.0
infused,0,0,2,0.015208455666470933,2,1.0
scratch,1,0,0,-0.007751027598355844,1,0.0
tax,2,0,0,-0.015443335290663537,2,1.0
lifetime,2,0,0,-0.015443335290663537,2,1.0
ticks,1,0,0,-0.007751027598355844,1,0.0
meticulously,1,0,0,-0.007751027598355844,1,0.0
accountant,1,0,0,-0.007751027598355844,1,0.0
milestones,1,0,1,-0.0001174398120963021,2,1.0
dutiful,2,0,0,-0.015443335290663537,2,1.0
behaved,1,0,0,-0.007751027598355844,1,0.0
exasperatingly,1,0,0,-0.007751027598355844,1,0.0
awarded,0,0,1,0.007574867880211391,1,0.0
mythic,1,0,2,0.0075161479741632405,3,1.5849625007211563
respite,0,0,1,0.007574867880211391,1,0.0
careens,0,0,1,0.007574867880211391,1,0.0
informed,0,0,1,0.007574867880211391,1,0.0
omnipresence,0,0,1,0.007574867880211391,1,0.0
brightness,0,0,1,0.007574867880211391,1,0.0
motifs,1,0,2,0.0075161479741632405,3,1.5849625007211563
inhabits,0,0,1,0.007574867880211391,1,0.0
pbs,1,0,0,-0.007751027598355844,1,0.0
dramatized,1,0,0,-0.007751027598355844,1,0.0
biography,0,0,1,0.007574867880211391,1,0.0
raboy,0,0,1,0.007574867880211391,1,0.0
vigorously,0,0,1,0.007574867880211391,1,0.0
cheer,0,0,3,0.022842043452730474,3,1.5849625007211563
eggnog,0,0,1,0.007574867880211391,1,0.0
spiked,1,0,1,-0.0001174398120963021,2,1.0
whiskey,0,0,1,0.007574867880211391,1,0.0
shapeless,2,0,2,-0.00017615971814445228,4,2.0
tucker,2,0,1,-0.007809747504403995,3,1.5849625007211563
spreads,1,0,0,-0.007751027598355844,1,0.0
insensitivity,1,0,0,-0.007751027598355844,1,0.0
broad,4,0,4,-0.00029359953024075264,8,3.0
uninteresting,3,0,0,-0.02313564298297123,3,1.5849625007211563
foul,2,0,2,-0.00017615971814445228,4,2.0
fix,1,0,1,-0.0001174398120963021,2,1.0
sitting,6,0,1,-0.03857897827363477,7,2.807354922057604
amoses,1,0,0,-0.007751027598355844,1,0.0
andys,1,0,0,-0.007751027598355844,1,0.0
considering,2,0,1,-0.007809747504403995,3,1.5849625007211563
snuck,1,0,0,-0.007751027598355844,1,0.0
sexist,2,0,1,-0.007809747504403995,3,1.5849625007211563
opting,0,0,1,0.007574867880211391,1,0.0
subversive,0,0,4,0.03047563123899002,4,2.0
blow,3,0,4,0.00739870816206694,7,2.807354922057604
elves,1,0,0,-0.007751027598355844,1,0.0
pimps,1,0,0,-0.007751027598355844,1,0.0
bluster,2,0,0,-0.015443335290663537,2,1.0
seinfeld,0,0,2,0.015208455666470933,2,1.0
dislocation,0,0,2,0.015208455666470933,2,1.0
clams,1,0,0,-0.007751027598355844,1,0.0
sun,3,0,0,-0.02313564298297123,3,1.5849625007211563
compare,1,0,0,-0.007751027598355844,1,0.0
broiling,1,0,0,-0.007751027598355844,1,0.0
decency,1,0,4,0.022783323546682326,5,2.321928094887362
displays,0,0,2,0.015208455666470933,2,1.0
correctness,0,0,3,0.022842043452730474,3,1.5849625007211563
damned,1,0,3,0.015149735760422781,4,2.0
jointed,1,0,0,-0.007751027598355844,1,0.0
loose,4,0,1,-0.023194362889019382,5,2.321928094887362
predecessor,3,0,5,0.015032295948326481,8,3.0
flatter,2,0,0,-0.015443335290663537,2,1.0
lump,2,0,1,-0.007809747504403995,3,1.5849625007211563
coal,2,0,0,-0.015443335290663537,2,1.0
frenetic,1,0,0,-0.007751027598355844,1,0.0
manically,0,0,1,0.007574867880211391,1,0.0
generous,1,0,1,-0.0001174398120963021,2,1.0
ranges,1,0,1,-0.0001174398120963021,2,1.0
sprinkled,2,0,0,-0.015443335290663537,2,1.0
bodacious,1,0,0,-0.007751027598355844,1,0.0
bedeviled,1,0,0,-0.007751027598355844,1,0.0
slack,2,0,0,-0.015443335290663537,2,1.0
hardy,1,0,1,-0.0001174398120963021,2,1.0
laurel,1,0,0,-0.007751027598355844,1,0.0
n,2,0,0,-0.015443335290663537,2,1.0
unmentionable,1,0,0,-0.007751027598355844,1,0.0
muck,1,0,0,-0.007751027598355844,1,0.0
splashing,1,0,0,-0.007751027598355844,1,0.0
hos,1,0,0,-0.007751027598355844,1,0.0
pics,2,0,0,-0.015443335290663537,2,1.0
virulent,1,0,1,-0.0001174398120963021,2,1.0
cleaning,0,0,1,0.007574867880211391,1,0.0
cooking,0,0,1,0.007574867880211391,1,0.0
trimming,0,0,1,0.007574867880211391,1,0.0
wrapping,0,0,1,0.007574867880211391,1,0.0
enjoys,1,0,0,-0.007751027598355844,1,0.0
personally,1,0,0,-0.007751027598355844,1,0.0
spinal,0,0,1,0.007574867880211391,1,0.0
fubar,0,0,1,0.007574867880211391,1,0.0
dowse,0,0,1,0.007574867880211391,1,0.0
contempt,0,0,1,0.007574867880211391,1,0.0
superficially,0,0,1,0.007574867880211391,1,0.0
adding,1,0,3,0.015149735760422781,4,2.0
headbanger,0,0,1,0.007574867880211391,1,0.0
leppard,0,0,1,0.007574867880211391,1,0.0
cassette,0,0,1,0.007574867880211391,1,0.0
pyromania,0,0,1,0.007574867880211391,1,0.0
unlucky,0,0,1,0.007574867880211391,1,0.0
def,0,0,1,0.007574867880211391,1,0.0
invigorating,0,0,3,0.022842043452730474,3,1.5849625007211563
abstract,4,0,0,-0.030827950675278923,4,2.0
improvisational,0,0,1,0.007574867880211391,1,0.0
absurdity,1,0,1,-0.0001174398120963021,2,1.0
noodling,0,0,1,0.007574867880211391,1,0.0
portent,1,0,0,-0.007751027598355844,1,0.0
attack,3,0,1,-0.015502055196711688,4,2.0
distorts,1,0,0,-0.007751027598355844,1,0.0
riddles,1,0,0,-0.007751027598355844,1,0.0
pretentiously,1,0,0,-0.007751027598355844,1,0.0
slike,1,0,0,-0.007751027598355844,1,0.0
aboul,1,0,0,-0.007751027598355844,1,0.0
elicited,1,0,0,-0.007751027598355844,1,0.0
sympathies,1,0,0,-0.007751027598355844,1,0.0
moviegoer,1,0,0,-0.007751027598355844,1,0.0
lured,1,0,0,-0.007751027598355844,1,0.0
overt,0,0,1,0.007574867880211391,1,0.0
precisely,1,0,2,0.0075161479741632405,3,1.5849625007211563
2000,1,0,2,0.0075161479741632405,3,1.5849625007211563
nominated,1,0,2,0.0075161479741632405,3,1.5849625007211563
dunno,1,0,0,-0.007751027598355844,1,0.0
ithell,1,0,0,-0.007751027598355844,1,0.0
philosophic,1,0,0,-0.007751027598355844,1,0.0
impenetrable,1,0,0,-0.007751027598355844,1,0.0
insufferable,1,0,0,-0.007751027598355844,1,0.0
overplotted,0,0,1,0.007574867880211391,1,0.0
elliptical,0,0,2,0.015208455666470933,2,1.0
fragmented,0,0,1,0.007574867880211391,1,0.0
gesture,0,0,1,0.007574867880211391,1,0.0
handy,1,0,0,-0.007751027598355844,1,0.0
eager,2,0,0,-0.015443335290663537,2,1.0
goosey,0,0,1,0.007574867880211391,1,0.0
loosey,0,0,1,0.007574867880211391,1,0.0
methodology,1,0,0,-0.007751027598355844,1,0.0
heads,4,0,0,-0.030827950675278923,4,2.0
hardened,1,0,0,-0.007751027598355844,1,0.0
ringing,2,0,0,-0.015443335290663537,2,1.0
mulholland,0,0,1,0.007574867880211391,1,0.0
magnolia,0,0,2,0.015208455666470933,2,1.0
technique,2,0,1,-0.007809747504403995,3,1.5849625007211563
tactic,1,0,0,-0.007751027598355844,1,0.0
flimsy,3,0,0,-0.02313564298297123,3,1.5849625007211563
nonexistent,1,0,0,-0.007751027598355844,1,0.0
ruse,1,0,0,-0.007751027598355844,1,0.0
dilettante,1,0,0,-0.007751027598355844,1,0.0
hailed,1,0,0,-0.007751027598355844,1,0.0
insights,3,0,1,-0.015502055196711688,4,2.0
pungent,1,0,0,-0.007751027598355844,1,0.0
subcultures,1,0,0,-0.007751027598355844,1,0.0
offering,3,0,4,0.00739870816206694,7,2.807354922057604
guidelines,1,0,0,-0.007751027598355844,1,0.0
cleverer,1,0,0,-0.007751027598355844,1,0.0
bet,2,0,2,-0.00017615971814445228,4,2.0
weinstein,0,0,1,0.007574867880211391,1,0.0
harvey,0,0,1,0.007574867880211391,1,0.0
rigors,0,0,1,0.007574867880211391,1,0.0
dogma,0,0,1,0.007574867880211391,1,0.0
denmark,0,0,1,0.007574867880211391,1,0.0
cineasts,0,0,1,0.007574867880211391,1,0.0
bluff,0,0,1,0.007574867880211391,1,0.0
miramax,3,0,1,-0.015502055196711688,4,2.0
revel,0,0,1,0.007574867880211391,1,0.0
classified,1,0,0,-0.007751027598355844,1,0.0
disingenuous,1,0,1,-0.0001174398120963021,2,1.0
nationwide,1,0,0,-0.007751027598355844,1,0.0
definitive,1,0,1,-0.0001174398120963021,2,1.0
opens,2,0,1,-0.007809747504403995,3,1.5849625007211563
inclusiveness,1,0,0,-0.007751027598355844,1,0.0
toasting,0,0,1,0.007574867880211391,1,0.0
pointless,5,0,1,-0.030886670581327075,6,2.584962500721156
eleven,1,0,1,-0.0001174398120963021,2,1.0
priced,0,0,1,0.007574867880211391,1,0.0
coolness,0,0,1,0.007574867880211391,1,0.0
unimpressively,1,0,0,-0.007751027598355844,1,0.0
fussy,2,0,0,-0.015443335290663537,2,1.0
pretentious,4,0,2,-0.015560775102759838,6,2.584962500721156
naturalistic,1,0,0,-0.007751027598355844,1,0.0
grainy,2,0,0,-0.015443335290663537,2,1.0
dependent,1,0,0,-0.007751027598355844,1,0.0
exhausting,1,0,0,-0.007751027598355844,1,0.0
endlessly,1,0,1,-0.0001174398120963021,2,1.0
landmark,0,0,1,0.007574867880211391,1,0.0
delayed,0,0,1,0.007574867880211391,1,0.0
scorcese,0,0,1,0.007574867880211391,1,0.0
brassy,0,0,1,0.007574867880211391,1,0.0
evolution,0,0,1,0.007574867880211391,1,0.0
esteticamente,1,0,0,-0.007751027598355844,1,0.0
emocionalmente,1,0,0,-0.007751027598355844,1,0.0
cria,1,0,0,-0.007751027598355844,1,0.0
frio,1,0,0,-0.007751027598355844,1,0.0
alma,1,0,0,-0.007751027598355844,1,0.0
espetáculo,1,0,0,-0.007751027598355844,1,0.0
possui,1,0,0,-0.007751027598355844,1,0.0
require,2,0,0,-0.015443335290663537,2,1.0
againthat,1,0,0,-0.007751027598355844,1,0.0
168,0,0,2,0.015208455666470933,2,1.0
eloquently,0,0,1,0.007574867880211391,1,0.0
goosebumps,0,0,1,0.007574867880211391,1,0.0
magnificently,0,0,1,0.007574867880211391,1,0.0
sprawling,1,0,2,0.0075161479741632405,3,1.5849625007211563
operatic,0,0,1,0.007574867880211391,1,0.0
170,0,0,1,0.007574867880211391,1,0.0
western,0,0,1,0.007574867880211391,1,0.0
gravity,1,0,1,-0.0001174398120963021,2,1.0
spaghetti,0,0,1,0.007574867880211391,1,0.0
imperfect,0,0,2,0.015208455666470933,2,1.0
worka,0,0,1,0.007574867880211391,1,0.0
sits,2,0,1,-0.007809747504403995,3,1.5849625007211563
w,1,0,1,-0.0001174398120963021,2,1.0
griffith,0,0,1,0.007574867880211391,1,0.0
silent,0,0,2,0.015208455666470933,2,1.0
faults,0,0,5,0.03810921902524956,5,2.321928094887362
stretching,2,0,0,-0.015443335290663537,2,1.0
rhyme,1,0,0,-0.007751027598355844,1,0.0
carnival,1,0,0,-0.007751027598355844,1,0.0
unapologetic,1,0,0,-0.007751027598355844,1,0.0
gruesome,0,0,1,0.007574867880211391,1,0.0
unfocused,1,0,3,0.015149735760422781,4,2.0
tragically,0,0,1,0.007574867880211391,1,0.0
conclusion,2,0,3,0.0074574280681150885,5,2.321928094887362
epics,0,0,1,0.007574867880211391,1,0.0
spite,0,0,2,0.015208455666470933,2,1.0
thematically,0,0,1,0.007574867880211391,1,0.0
peppered,0,0,2,0.015208455666470933,2,1.0
hindered,0,0,1,0.007574867880211391,1,0.0
lethargic,0,0,1,0.007574867880211391,1,0.0
stomach,6,0,2,-0.030945390487375223,8,3.0
hallmarks,1,0,1,-0.0001174398120963021,2,1.0
enthusiasms,1,0,0,-0.007751027598355844,1,0.0
roars,0,0,1,0.007574867880211391,1,0.0
pageantry,0,0,1,0.007574867880211391,1,0.0
leonine,0,0,1,0.007574867880211391,1,0.0
vanished,0,0,1,0.007574867880211391,1,0.0
thrall,1,0,1,-0.0001174398120963021,2,1.0
bookkeepers,0,0,1,0.007574867880211391,1,0.0
ballhaus,1,0,0,-0.007751027598355844,1,0.0
cinematographer,2,0,1,-0.007809747504403995,3,1.5849625007211563
courage,3,0,4,0.00739870816206694,7,2.807354922057604
bravery,0,0,2,0.015208455666470933,2,1.0
underestimated,0,0,1,0.007574867880211391,1,0.0
ideology,0,0,1,0.007574867880211391,1,0.0
conservative,1,0,1,-0.0001174398120963021,2,1.0
advancing,0,0,1,0.007574867880211391,1,0.0
balm,1,0,1,-0.0001174398120963021,2,1.0
vivid,1,0,2,0.0075161479741632405,3,1.5849625007211563
splashed,1,0,1,-0.0001174398120963021,2,1.0
reverberates,0,0,1,0.007574867880211391,1,0.0
achieved,0,0,1,0.007574867880211391,1,0.0
recall,2,0,3,0.0074574280681150885,5,2.321928094887362
entranced,0,0,1,0.007574867880211391,1,0.0
thirds,0,0,1,0.007574867880211391,1,0.0
revived,1,0,0,-0.007751027598355844,1,0.0
primal,0,0,1,0.007574867880211391,1,0.0
candle,1,0,1,-0.0001174398120963021,2,1.0
respectably,0,0,1,0.007574867880211391,1,0.0
seas,2,0,1,-0.007809747504403995,3,1.5849625007211563
mentioned,1,0,0,-0.007751027598355844,1,0.0
moodily,1,0,0,-0.007751027598355844,1,0.0
interiors,1,0,0,-0.007751027598355844,1,0.0
effectively,1,0,1,-0.0001174398120963021,2,1.0
qualify,2,0,0,-0.015443335290663537,2,1.0
previously,1,0,0,-0.007751027598355844,1,0.0
skulls,1,0,0,-0.007751027598355844,1,0.0
overboard,2,0,0,-0.015443335290663537,2,1.0
yale,1,0,0,-0.007751027598355844,1,0.0
pogue,1,0,0,-0.007751027598355844,1,0.0
rusty,1,0,0,-0.007751027598355844,1,0.0
creaking,1,0,0,-0.007751027598355844,1,0.0
beck,2,0,0,-0.015443335290663537,2,1.0
combining,1,0,0,-0.007751027598355844,1,0.0
doris,0,0,1,0.007574867880211391,1,0.0
til,0,0,1,0.007574867880211391,1,0.0
restage,1,0,0,-0.007751027598355844,1,0.0
minimal,1,0,0,-0.007751027598355844,1,0.0
bathtub,2,0,0,-0.015443335290663537,2,1.0
adjectives,1,0,0,-0.007751027598355844,1,0.0
vile,2,0,0,-0.015443335290663537,2,1.0
tacky,2,0,1,-0.007809747504403995,3,1.5849625007211563
slide,2,0,0,-0.015443335290663537,2,1.0
freebie,1,0,0,-0.007751027598355844,1,0.0
importantly,1,0,0,-0.007751027598355844,1,0.0
dumber,1,0,0,-0.007751027598355844,1,0.0
underwear,1,0,1,-0.0001174398120963021,2,1.0
zemeckis,1,0,0,-0.007751027598355844,1,0.0
heavyweights,1,0,0,-0.007751027598355844,1,0.0
agreed,1,0,0,-0.007751027598355844,1,0.0
cavorting,1,0,0,-0.007751027598355844,1,0.0
messjust,1,0,0,-0.007751027598355844,1,0.0
abyss,2,0,1,-0.007809747504403995,3,1.5849625007211563
alternative,1,0,0,-0.007751027598355844,1,0.0
telegraphed,3,0,0,-0.02313564298297123,3,1.5849625007211563
landbound,1,0,0,-0.007751027598355844,1,0.0
sucks,2,0,0,-0.015443335290663537,2,1.0
pumping,0,0,2,0.015208455666470933,2,1.0
castle,0,0,1,0.007574867880211391,1,0.0
schlocky,1,0,1,-0.0001174398120963021,2,1.0
nachos,0,0,1,0.007574867880211391,1,0.0
overwhelmed,0,0,1,0.007574867880211391,1,0.0
cheese,2,0,4,0.015091015854374633,6,2.584962500721156
cheddar,0,0,1,0.007574867880211391,1,0.0
doings,1,0,0,-0.007751027598355844,1,0.0
minds,2,0,2,-0.00017615971814445228,4,2.0
signposts,1,0,0,-0.007751027598355844,1,0.0
analgesic,1,0,0,-0.007751027598355844,1,0.0
lingering,1,0,2,0.0075161479741632405,3,1.5849625007211563
overstimulated,1,0,0,-0.007751027598355844,1,0.0
satanic,1,0,0,-0.007751027598355844,1,0.0
abundance,1,0,0,-0.007751027598355844,1,0.0
severed,1,0,0,-0.007751027598355844,1,0.0
jolting,1,0,0,-0.007751027598355844,1,0.0
drowsy,2,0,0,-0.015443335290663537,2,1.0
wetsuit,1,0,0,-0.007751027598355844,1,0.0
swimmer,1,0,0,-0.007751027598355844,1,0.0
wool,1,0,0,-0.007751027598355844,1,0.0
synchronized,1,0,0,-0.007751027598355844,1,0.0
heaviness,1,0,0,-0.007751027598355844,1,0.0
reparations,1,0,0,-0.007751027598355844,1,0.0
blimp,1,0,0,-0.007751027598355844,1,0.0
prospect,1,0,0,-0.007751027598355844,1,0.0
scare,2,0,1,-0.007809747504403995,3,1.5849625007211563
pants,1,0,1,-0.0001174398120963021,2,1.0
substitutes,2,0,0,-0.015443335290663537,2,1.0
gore,2,0,1,-0.007809747504403995,3,1.5849625007211563
fanatics,1,0,0,-0.007751027598355844,1,0.0
skip,7,0,1,-0.04627128596594246,8,3.0
aiello,1,0,0,-0.007751027598355844,1,0.0
mumbles,1,0,0,-0.007751027598355844,1,0.0
gotten,3,0,2,-0.007868467410452145,5,2.321928094887362
kurupt,1,0,0,-0.007751027598355844,1,0.0
benefitted,1,0,0,-0.007751027598355844,1,0.0
ineptly,2,0,0,-0.015443335290663537,2,1.0
throwaway,2,0,1,-0.007809747504403995,3,1.5849625007211563
chasm,0,0,1,0.007574867880211391,1,0.0
yawning,1,0,1,-0.0001174398120963021,2,1.0
mo,2,0,0,-0.015443335290663537,2,1.0
88,2,0,0,-0.015443335290663537,2,1.0
slo,2,0,0,-0.015443335290663537,2,1.0
performs,1,0,0,-0.007751027598355844,1,0.0
dimension,2,0,1,-0.007809747504403995,3,1.5849625007211563
fireworks,2,0,0,-0.015443335290663537,2,1.0
normally,1,0,0,-0.007751027598355844,1,0.0
jumpsuit,1,0,0,-0.007751027598355844,1,0.0
hey,7,0,2,-0.03863769817968292,9,3.1699250014423126
appeared,1,0,0,-0.007751027598355844,1,0.0
kool,1,0,0,-0.007751027598355844,1,0.0
angle,1,0,0,-0.007751027598355844,1,0.0
regurgitated,1,0,0,-0.007751027598355844,1,0.0
siege,2,0,0,-0.015443335290663537,2,1.0
copycat,1,0,0,-0.007751027598355844,1,0.0
modeled,1,0,0,-0.007751027598355844,1,0.0
springs,1,0,0,-0.007751027598355844,1,0.0
corpse,2,0,0,-0.015443335290663537,2,1.0
shape,1,0,0,-0.007751027598355844,1,0.0
chopsocky,1,0,0,-0.007751027598355844,1,0.0
foolish,2,0,0,-0.015443335290663537,2,1.0
passe,1,0,1,-0.0001174398120963021,2,1.0
assembled,4,0,1,-0.023194362889019382,5,2.321928094887362
marginally,1,0,0,-0.007751027598355844,1,0.0
frankenstein,2,0,0,-0.015443335290663537,2,1.0
ran,1,0,0,-0.007751027598355844,1,0.0
clinch,1,0,0,-0.007751027598355844,1,0.0
razzie,2,0,0,-0.015443335290663537,2,1.0
strenuous,1,0,0,-0.007751027598355844,1,0.0
zoom,1,0,0,-0.007751027598355844,1,0.0
giddy,1,0,1,-0.0001174398120963021,2,1.0
bash,1,0,0,-0.007751027598355844,1,0.0
splitting,1,0,0,-0.007751027598355844,1,0.0
headbangingly,1,0,0,-0.007751027598355844,1,0.0
divertingly,1,0,0,-0.007751027598355844,1,0.0
flies,1,0,0,-0.007751027598355844,1,0.0
window,3,0,1,-0.015502055196711688,4,2.0
sascha,1,0,0,-0.007751027598355844,1,0.0
pessimists,1,0,0,-0.007751027598355844,1,0.0
louder,1,0,0,-0.007751027598355844,1,0.0
ponytail,1,0,0,-0.007751027598355844,1,0.0
testosterone,3,0,0,-0.02313564298297123,3,1.5849625007211563
decommissioned,1,0,0,-0.007751027598355844,1,0.0
handkerchief,1,0,0,-0.007751027598355844,1,0.0
chloroform,1,0,0,-0.007751027598355844,1,0.0
fantastical,1,0,0,-0.007751027598355844,1,0.0
laundry,1,0,0,-0.007751027598355844,1,0.0
slashers,1,0,0,-0.007751027598355844,1,0.0
elapse,1,0,0,-0.007751027598355844,1,0.0
mass,1,0,0,-0.007751027598355844,1,0.0
mask,2,0,1,-0.007809747504403995,3,1.5849625007211563
daddy,2,0,0,-0.015443335290663537,2,1.0
boiler,1,0,0,-0.007751027598355844,1,0.0
slightest,1,0,1,-0.0001174398120963021,2,1.0
attributable,1,0,0,-0.007751027598355844,1,0.0
hash,2,0,0,-0.015443335290663537,2,1.0
slasher,3,0,0,-0.02313564298297123,3,1.5849625007211563
sunk,3,0,0,-0.02313564298297123,3,1.5849625007211563
measurements,1,0,0,-0.007751027598355844,1,0.0
distinction,1,0,0,-0.007751027598355844,1,0.0
witch,7,0,0,-0.053904873752202,7,2.807354922057604
resurrection,3,0,2,-0.007868467410452145,5,2.321928094887362
laurie,0,0,1,0.007574867880211391,1,0.0
rosenthal,1,0,0,-0.007751027598355844,1,0.0
generating,3,0,0,-0.02313564298297123,3,1.5849625007211563
unappealing,1,0,0,-0.007751027598355844,1,0.0
handheld,2,0,0,-0.015443335290663537,2,1.0
cam,1,0,0,-0.007751027598355844,1,0.0
degraded,1,0,0,-0.007751027598355844,1,0.0
replacing,1,0,0,-0.007751027598355844,1,0.0
splat,0,0,1,0.007574867880211391,1,0.0
slash,2,0,1,-0.007809747504403995,3,1.5849625007211563
objects,1,0,0,-0.007751027598355844,1,0.0
environmental,1,0,0,-0.007751027598355844,1,0.0
conceptions,1,0,0,-0.007751027598355844,1,0.0
bodies,1,0,0,-0.007751027598355844,1,0.0
gored,1,0,0,-0.007751027598355844,1,0.0
entries,1,0,0,-0.007751027598355844,1,0.0
rung,1,0,0,-0.007751027598355844,1,0.0
stalk,1,0,0,-0.007751027598355844,1,0.0
unsatisfying,2,0,0,-0.015443335290663537,2,1.0
tapping,1,0,1,-0.0001174398120963021,2,1.0
tardier,1,0,0,-0.007751027598355844,1,0.0
webcast,1,0,0,-0.007751027598355844,1,0.0
novelty,1,0,0,-0.007751027598355844,1,0.0
exploiting,1,0,1,-0.0001174398120963021,2,1.0
soap,7,0,2,-0.03863769817968292,9,3.1699250014423126
buying,1,0,0,-0.007751027598355844,1,0.0
affirming,2,0,0,-0.015443335290663537,2,1.0
demonstrating,1,0,0,-0.007751027598355844,1,0.0
playoff,1,0,0,-0.007751027598355844,1,0.0
arrived,1,0,0,-0.007751027598355844,1,0.0
villain,1,0,4,0.022783323546682326,5,2.321928094887362
invulnerable,1,0,0,-0.007751027598355844,1,0.0
weary,2,0,1,-0.007809747504403995,3,1.5849625007211563
positively,1,0,0,-0.007751027598355844,1,0.0
shakesperean,1,0,0,-0.007751027598355844,1,0.0
grubbing,2,0,0,-0.015443335290663537,2,1.0
uselessly,1,0,0,-0.007751027598355844,1,0.0
parade,3,0,1,-0.015502055196711688,4,2.0
spectators,1,0,0,-0.007751027598355844,1,0.0
mouthed,2,0,0,-0.015443335290663537,2,1.0
looked,5,0,0,-0.038520258367586616,5,2.321928094887362
shoe,0,0,1,0.007574867880211391,1,0.0
shine,0,0,3,0.022842043452730474,3,1.5849625007211563
polish,0,0,1,0.007574867880211391,1,0.0
sorcerer,0,0,3,0.022842043452730474,3,1.5849625007211563
scarier,1,0,3,0.015149735760422781,4,2.0
earning,0,0,1,0.007574867880211391,1,0.0
improvement,0,0,3,0.022842043452730474,3,1.5849625007211563
enchanting,0,0,2,0.015208455666470933,2,1.0
mischief,0,0,1,0.007574867880211391,1,0.0
mediocrity,3,0,0,-0.02313564298297123,3,1.5849625007211563
interminably,0,0,1,0.007574867880211391,1,0.0
columbus,1,0,4,0.022783323546682326,5,2.321928094887362
cracks,1,0,1,-0.0001174398120963021,2,1.0
obscenely,0,0,1,0.007574867880211391,1,0.0
margins,0,0,1,0.007574867880211391,1,0.0
stronger,1,0,2,0.0075161479741632405,3,1.5849625007211563
thinnest,0,0,1,0.007574867880211391,1,0.0
weakest,1,0,1,-0.0001174398120963021,2,1.0
nimble,0,0,2,0.015208455666470933,2,1.0
livelier,0,0,1,0.007574867880211391,1,0.0
enchantingterribly,1,0,0,-0.007751027598355844,1,0.0
episodic,3,0,1,-0.015502055196711688,4,2.0
realm,2,0,2,-0.00017615971814445228,4,2.0
soars,1,0,0,-0.007751027598355844,1,0.0
rollicking,0,0,4,0.03047563123899002,4,2.0
quieter,0,0,2,0.015208455666470933,2,1.0
reacting,1,0,1,-0.0001174398120963021,2,1.0
delights,1,0,3,0.015149735760422781,4,2.0
urgently,0,0,1,0.007574867880211391,1,0.0
mercy,1,0,1,-0.0001174398120963021,2,1.0
struggled,0,0,1,0.007574867880211391,1,0.0
capturou,0,0,1,0.007574867880211391,1,0.0
vez,3,0,2,-0.007868467410452145,5,2.321928094887362
desta,1,0,1,-0.0001174398120963021,2,1.0
ouro,0,0,1,0.007574867880211391,1,0.0
pomo,0,0,1,0.007574867880211391,1,0.0
electricity,0,0,1,0.007574867880211391,1,0.0
newness,0,0,1,0.007574867880211391,1,0.0
talky,1,0,1,-0.0001174398120963021,2,1.0
likably,0,0,1,0.007574867880211391,1,0.0
rowling,2,0,2,-0.00017615971814445228,4,2.0
round,0,0,2,0.015208455666470933,2,1.0
sellers,0,0,1,0.007574867880211391,1,0.0
headlong,0,0,1,0.007574867880211391,1,0.0
timeframe,0,0,1,0.007574867880211391,1,0.0
sized,1,0,3,0.015149735760422781,4,2.0
mandates,0,0,1,0.007574867880211391,1,0.0
soda,0,0,1,0.007574867880211391,1,0.0
godzilla,1,0,2,0.0075161479741632405,3,1.5849625007211563
marvelous,1,0,5,0.030416911332941866,6,2.584962500721156
freshman,0,0,1,0.007574867880211391,1,0.0
introduction,0,0,1,0.007574867880211391,1,0.0
stifles,1,0,0,-0.007751027598355844,1,0.0
amazement,1,0,1,-0.0001174398120963021,2,1.0
detailed,0,0,2,0.015208455666470933,2,1.0
resonant,1,0,3,0.015149735760422781,4,2.0
inventively,0,0,1,0.007574867880211391,1,0.0
improved,0,0,1,0.007574867880211391,1,0.0
flow,1,0,1,-0.0001174398120963021,2,1.0
conjures,0,0,1,0.007574867880211391,1,0.0
fairness,0,0,1,0.007574867880211391,1,0.0
varying,0,0,1,0.007574867880211391,1,0.0
fidgeted,0,0,1,0.007574867880211391,1,0.0
bathroom,0,0,1,0.007574867880211391,1,0.0
coughed,0,0,1,0.007574867880211391,1,0.0
romped,0,0,1,0.007574867880211391,1,0.0
canon,0,0,1,0.007574867880211391,1,0.0
stoically,0,0,1,0.007574867880211391,1,0.0
tributes,0,0,1,0.007574867880211391,1,0.0
chess,0,0,1,0.007574867880211391,1,0.0
hollowed,1,0,0,-0.007751027598355844,1,0.0
bunks,1,0,0,-0.007751027598355844,1,0.0
powerfully,1,0,0,-0.007751027598355844,1,0.0
barrack,1,0,0,-0.007751027598355844,1,0.0
trim,1,0,1,-0.0001174398120963021,2,1.0
meanders,3,0,0,-0.02313564298297123,3,1.5849625007211563
nifty,0,0,1,0.007574867880211391,1,0.0
willis,3,0,3,-0.0002348796241926042,6,2.584962500721156
amalgamating,0,0,1,0.007574867880211391,1,0.0
breathes,0,0,2,0.015208455666470933,2,1.0
latrine,1,0,0,-0.007751027598355844,1,0.0
flushed,1,0,0,-0.007751027598355844,1,0.0
heroism,1,0,0,-0.007751027598355844,1,0.0
diverse,0,0,2,0.015208455666470933,2,1.0
prejudice,0,0,1,0.007574867880211391,1,0.0
reaching,1,0,1,-0.0001174398120963021,2,1.0
rocket,0,0,1,0.007574867880211391,1,0.0
51,0,0,1,0.007574867880211391,1,0.0
craters,0,0,1,0.007574867880211391,1,0.0
contemplate,0,0,1,0.007574867880211391,1,0.0
littered,1,0,2,0.0075161479741632405,3,1.5849625007211563
murk,1,0,0,-0.007751027598355844,1,0.0
battlefield,2,0,0,-0.015443335290663537,2,1.0
gray,1,0,1,-0.0001174398120963021,2,1.0
shades,0,0,2,0.015208455666470933,2,1.0
dominant,0,0,1,0.007574867880211391,1,0.0
mainly,2,0,2,-0.00017615971814445228,4,2.0
outshine,0,0,2,0.015208455666470933,2,1.0
farrell,0,0,1,0.007574867880211391,1,0.0
thankfully,0,0,3,0.022842043452730474,3,1.5849625007211563
titled,3,0,0,-0.02313564298297123,3,1.5849625007211563
soldier,2,0,1,-0.007809747504403995,3,1.5849625007211563
dissolves,1,0,0,-0.007751027598355844,1,0.0
suited,3,0,0,-0.02313564298297123,3,1.5849625007211563
cartoonswhen,0,0,1,0.007574867880211391,1,0.0
17but,0,0,1,0.007574867880211391,1,0.0
prisoner,0,0,1,0.007574867880211391,1,0.0
scar,1,0,0,-0.007751027598355844,1,0.0
compact,0,0,2,0.015208455666470933,2,1.0
filmbut,1,0,0,-0.007751027598355844,1,0.0
praise,1,0,2,0.0075161479741632405,3,1.5849625007211563
servicable,0,0,1,0.007574867880211391,1,0.0
caved,0,0,1,0.007574867880211391,1,0.0
muted,2,0,0,-0.015443335290663537,2,1.0
salute,1,0,2,0.0075161479741632405,3,1.5849625007211563
grimly,1,0,1,-0.0001174398120963021,2,1.0
whit,0,0,1,0.007574867880211391,1,0.0
showcase,2,0,1,-0.007809747504403995,3,1.5849625007211563
desired,3,0,0,-0.02313564298297123,3,1.5849625007211563
enlightenment,1,0,0,-0.007751027598355844,1,0.0
rams,1,0,0,-0.007751027598355844,1,0.0
waits,1,0,0,-0.007751027598355844,1,0.0
bowl,1,0,0,-0.007751027598355844,1,0.0
piesiewicz,0,0,2,0.015208455666470933,2,1.0
veronique,0,0,1,0.007574867880211391,1,0.0
poetic,2,0,1,-0.007809747504403995,3,1.5849625007211563
symbolism,0,0,1,0.007574867880211391,1,0.0
arthouse,0,0,2,0.015208455666470933,2,1.0
seats,0,0,2,0.015208455666470933,2,1.0
dunk,0,0,1,0.007574867880211391,1,0.0
transcendent,0,0,2,0.015208455666470933,2,1.0
impulsive,0,0,2,0.015208455666470933,2,1.0
sorrowful,0,0,1,0.007574867880211391,1,0.0
nichesgorgeous,0,0,1,0.007574867880211391,1,0.0
reinvigorated,0,0,1,0.007574867880211391,1,0.0
sweeping,0,0,2,0.015208455666470933,2,1.0
considerably,0,0,2,0.015208455666470933,2,1.0
gorgeously,0,0,2,0.015208455666470933,2,1.0
premeditated,0,0,1,0.007574867880211391,1,0.0
vigilant,0,0,1,0.007574867880211391,1,0.0
graceful,1,0,1,-0.0001174398120963021,2,1.0
vapid,9,0,0,-0.06928948913681739,9,3.1699250014423126
precio,1,0,0,-0.007751027598355844,1,0.0
sensación,1,0,0,-0.007751027598355844,1,0.0
si,1,0,1,-0.0001174398120963021,2,1.0
místico,1,0,0,-0.007751027598355844,1,0.0
boleto,1,0,0,-0.007751027598355844,1,0.0
pocas,1,0,0,-0.007751027598355844,1,0.0
pensar,1,0,1,-0.0001174398120963021,2,1.0
interesantes,1,0,1,-0.0001174398120963021,2,1.0
corresponde,1,0,0,-0.007751027598355844,1,0.0
tono,1,0,0,-0.007751027598355844,1,0.0
ir,1,0,0,-0.007751027598355844,1,0.0
inconformidad,1,0,0,-0.007751027598355844,1,0.0
taquilla,1,0,0,-0.007751027598355844,1,0.0
reclamar,1,0,0,-0.007751027598355844,1,0.0
hace,2,0,0,-0.015443335290663537,2,1.0
halo,0,0,1,0.007574867880211391,1,0.0
gutsy,0,0,1,0.007574867880211391,1,0.0
harp,0,0,1,0.007574867880211391,1,0.0
initial,0,0,1,0.007574867880211391,1,0.0
agey,0,0,1,0.007574867880211391,1,0.0
jarring,0,0,2,0.015208455666470933,2,1.0
chord,0,0,3,0.022842043452730474,3,1.5849625007211563
ascension,0,0,1,0.007574867880211391,1,0.0
dramatization,0,0,1,0.007574867880211391,1,0.0
savour,0,0,1,0.007574867880211391,1,0.0
aspect,1,0,3,0.015149735760422781,4,2.0
spiritual,0,0,1,0.007574867880211391,1,0.0
badlands,0,0,1,0.007574867880211391,1,0.0
tykwer,3,0,1,-0.015502055196711688,4,2.0
morally,3,0,1,-0.015502055196711688,4,2.0
spiritually,0,0,2,0.015208455666470933,2,1.0
unfulfilled,1,0,0,-0.007751027598355844,1,0.0
suffice,1,0,0,-0.007751027598355844,1,0.0
anti,5,0,2,-0.02325308279506753,7,2.807354922057604
seeming,2,0,1,-0.007809747504403995,3,1.5849625007211563
ethereal,1,0,0,-0.007751027598355844,1,0.0
jags,1,0,0,-0.007751027598355844,1,0.0
whiny,3,0,0,-0.02313564298297123,3,1.5849625007211563
contradicts,1,0,1,-0.0001174398120963021,2,1.0
aspired,1,0,0,-0.007751027598355844,1,0.0
pessimism,1,0,0,-0.007751027598355844,1,0.0
lyrical,1,0,0,-0.007751027598355844,1,0.0
condition,2,0,0,-0.015443335290663537,2,1.0
confirms,0,0,2,0.015208455666470933,2,1.0
ensures,0,0,2,0.015208455666470933,2,1.0
fable,1,0,1,-0.0001174398120963021,2,1.0
draggy,0,0,1,0.007574867880211391,1,0.0
pony,3,0,0,-0.02313564298297123,3,1.5849625007211563
softheaded,1,0,0,-0.007751027598355844,1,0.0
metaphysical,1,0,0,-0.007751027598355844,1,0.0
piano,1,0,0,-0.007751027598355844,1,0.0
repetitive,4,0,0,-0.030827950675278923,4,2.0
insistent,1,0,0,-0.007751027598355844,1,0.0
scream,2,0,1,-0.007809747504403995,3,1.5849625007211563
maddeningly,1,0,1,-0.0001174398120963021,2,1.0
reduce,2,0,0,-0.015443335290663537,2,1.0
drab,0,0,1,0.007574867880211391,1,0.0
complaints,0,0,1,0.007574867880211391,1,0.0
translation,2,0,0,-0.015443335290663537,2,1.0
mantra,1,0,0,-0.007751027598355844,1,0.0
frowns,1,0,0,-0.007751027598355844,1,0.0
blurry,2,0,0,-0.015443335290663537,2,1.0
ugliest,1,0,0,-0.007751027598355844,1,0.0
prominently,0,0,1,0.007574867880211391,1,0.0
rugrats,0,0,2,0.015208455666470933,2,1.0
helga,0,0,1,0.007574867880211391,1,0.0
irrational,0,0,1,0.007574867880211391,1,0.0
commended,0,0,2,0.015208455666470933,2,1.0
bartlett,1,0,1,-0.0001174398120963021,2,1.0
illustrating,0,0,1,0.007574867880211391,1,0.0
merits,0,0,1,0.007574867880211391,1,0.0
animated,4,0,5,0.007339988256018788,9,3.1699250014423126
unambitious,1,0,0,-0.007751027598355844,1,0.0
glee,2,0,0,-0.015443335290663537,2,1.0
exclamation,2,0,0,-0.015443335290663537,2,1.0
daytime,1,0,1,-0.0001174398120963021,2,1.0
serviceability,1,0,0,-0.007751027598355844,1,0.0
afternoon,3,0,0,-0.02313564298297123,3,1.5849625007211563
cartoon,11,0,2,-0.06940692894891369,13,3.700439718141092
bastards,1,0,0,-0.007751027598355844,1,0.0
greedy,1,0,0,-0.007751027598355844,1,0.0
elsewhere,3,0,0,-0.02313564298297123,3,1.5849625007211563
uninspired,10,0,0,-0.07698179682912508,10,3.3219280948873626
episodes,1,0,2,0.0075161479741632405,3,1.5849625007211563
activism,1,0,0,-0.007751027598355844,1,0.0
mcdonald,1,0,0,-0.007751027598355844,1,0.0
savvy,1,0,3,0.015149735760422781,4,2.0
acceptable,4,0,2,-0.015560775102759838,6,2.584962500721156
dickensian,2,0,2,-0.00017615971814445228,4,2.0
stretched,3,0,1,-0.015502055196711688,4,2.0
updated,1,0,0,-0.007751027598355844,1,0.0
sensibility,2,0,0,-0.015443335290663537,2,1.0
appreciation,1,0,0,-0.007751027598355844,1,0.0
depend,2,0,0,-0.015443335290663537,2,1.0
derived,2,0,1,-0.007809747504403995,3,1.5849625007211563
resistance,0,0,1,0.007574867880211391,1,0.0
projection,1,0,0,-0.007751027598355844,1,0.0
bounce,0,0,1,0.007574867880211391,1,0.0
hastily,3,0,0,-0.02313564298297123,3,1.5849625007211563
wrinkles,0,0,1,0.007574867880211391,1,0.0
unsightly,0,0,1,0.007574867880211391,1,0.0
immersion,0,0,1,0.007574867880211391,1,0.0
identify,0,0,1,0.007574867880211391,1,0.0
franklin,2,0,2,-0.00017615971814445228,4,2.0
economical,1,0,2,0.0075161479741632405,3,1.5849625007211563
carl,1,0,1,-0.0001174398120963021,2,1.0
bogs,1,0,0,-0.007751027598355844,1,0.0
thuggery,1,0,0,-0.007751027598355844,1,0.0
tactics,1,0,0,-0.007751027598355844,1,0.0
setup,2,0,1,-0.007809747504403995,3,1.5849625007211563
biter,0,0,1,0.007574867880211391,1,0.0
buff,2,0,0,-0.015443335290663537,2,1.0
marred,1,0,0,-0.007751027598355844,1,0.0
disastrous,1,0,0,-0.007751027598355844,1,0.0
poetically,1,0,0,-0.007751027598355844,1,0.0
represent,1,0,0,-0.007751027598355844,1,0.0
laziest,2,0,0,-0.015443335290663537,2,1.0
exemplify,1,0,0,-0.007751027598355844,1,0.0
miscasts,1,0,0,-0.007751027598355844,1,0.0
freeman,3,0,2,-0.007868467410452145,5,2.321928094887362
idiotic,3,0,0,-0.02313564298297123,3,1.5849625007211563
absurd,4,0,0,-0.030827950675278923,4,2.0
judd,4,0,3,-0.007927187316500297,7,2.807354922057604
litmus,2,0,0,-0.015443335290663537,2,1.0
pedigree,3,0,0,-0.02313564298297123,3,1.5849625007211563
celluloid,2,0,0,-0.015443335290663537,2,1.0
backward,1,0,0,-0.007751027598355844,1,0.0
tiresomely,2,0,0,-0.015443335290663537,2,1.0
regimented,1,0,0,-0.007751027598355844,1,0.0
dialog,1,0,0,-0.007751027598355844,1,0.0
disagreeable,1,0,0,-0.007751027598355844,1,0.0
overtly,1,0,1,-0.0001174398120963021,2,1.0
morgan,2,0,0,-0.015443335290663537,2,1.0
finder,1,0,0,-0.007751027598355844,1,0.0
opportunism,1,0,0,-0.007751027598355844,1,0.0
joseph,1,0,0,-0.007751027598355844,1,0.0
flog,1,0,0,-0.007751027598355844,1,0.0
obligation,1,0,0,-0.007751027598355844,1,0.0
horse,1,0,0,-0.007751027598355844,1,0.0
freak,0,0,1,0.007574867880211391,1,0.0
outs,0,0,1,0.007574867880211391,1,0.0
flourishes,1,0,2,0.0075161479741632405,3,1.5849625007211563
advice,5,0,0,-0.038520258367586616,5,2.321928094887362
choices,3,0,1,-0.015502055196711688,4,2.0
misdemeanor,2,0,0,-0.015443335290663537,2,1.0
organic,2,0,0,-0.015443335290663537,2,1.0
province,1,0,0,-0.007751027598355844,1,0.0
subliminally,1,0,0,-0.007751027598355844,1,0.0
loitering,1,0,0,-0.007751027598355844,1,0.0
disparate,2,0,2,-0.00017615971814445228,4,2.0
steals,0,0,3,0.022842043452730474,3,1.5849625007211563
freely,0,0,1,0.007574867880211391,1,0.0
misuse,1,0,0,-0.007751027598355844,1,0.0
conforms,1,0,0,-0.007751027598355844,1,0.0
detractors,0,0,1,0.007574867880211391,1,0.0
convert,0,0,1,0.007574867880211391,1,0.0
breathe,2,0,1,-0.007809747504403995,3,1.5849625007211563
dope,2,0,0,-0.015443335290663537,2,1.0
aged,2,0,1,-0.007809747504403995,3,1.5849625007211563
sour,4,0,0,-0.030827950675278923,4,2.0
grapes,1,0,0,-0.007751027598355844,1,0.0
turgid,1,0,0,-0.007751027598355844,1,0.0
neighbor,1,0,0,-0.007751027598355844,1,0.0
knickknacks,1,0,0,-0.007751027598355844,1,0.0
sale,1,0,0,-0.007751027598355844,1,0.0
closing,3,0,0,-0.02313564298297123,3,1.5849625007211563
ambling,0,0,1,0.007574867880211391,1,0.0
larga,0,0,1,0.007574867880211391,1,0.0
nos,1,0,1,-0.0001174398120963021,2,1.0
atacarse,0,0,1,0.007574867880211391,1,0.0
sonrisa,0,0,1,0.007574867880211391,1,0.0
risa,0,0,1,0.007574867880211391,1,0.0
ofrece,0,0,1,0.007574867880211391,1,0.0
duración,0,0,1,0.007574867880211391,1,0.0
atacar,0,0,1,0.007574867880211391,1,0.0
atreve,0,0,1,0.007574867880211391,1,0.0
baffling,2,0,2,-0.00017615971814445228,4,2.0
flop,2,0,0,-0.015443335290663537,2,1.0
wears,2,0,1,-0.007809747504403995,3,1.5849625007211563
triflea,0,0,1,0.007574867880211391,1,0.0
jocular,0,0,1,0.007574867880211391,1,0.0
anymore,0,0,1,0.007574867880211391,1,0.0
warmed,4,0,0,-0.030827950675278923,4,2.0
stoppingly,0,0,1,0.007574867880211391,1,0.0
scathingly,0,0,1,0.007574867880211391,1,0.0
groove,1,0,1,-0.0001174398120963021,2,1.0
churn,1,0,0,-0.007751027598355844,1,0.0
outgag,0,0,1,0.007574867880211391,1,0.0
whippersnappers,0,0,1,0.007574867880211391,1,0.0
snobbery,1,0,0,-0.007751027598355844,1,0.0
diversions,1,0,0,-0.007751027598355844,1,0.0
satiric,1,0,0,-0.007751027598355844,1,0.0
imitating,2,0,0,-0.015443335290663537,2,1.0
draws,1,0,0,-0.007751027598355844,1,0.0
cal,1,0,0,-0.007751027598355844,1,0.0
guffaw,1,0,2,0.0075161479741632405,3,1.5849625007211563
shiver,0,0,2,0.015208455666470933,2,1.0
leoni,0,0,1,0.007574867880211391,1,0.0
spun,0,0,1,0.007574867880211391,1,0.0
surpassed,0,0,1,0.007574867880211391,1,0.0
empress,0,0,1,0.007574867880211391,1,0.0
ellie,0,0,1,0.007574867880211391,1,0.0
66,1,0,0,-0.007751027598355844,1,0.0
worthwhile,2,0,4,0.015091015854374633,6,2.584962500721156
thurman,0,0,2,0.015208455666470933,2,1.0
nair,0,0,2,0.015208455666470933,2,1.0
overload,1,0,0,-0.007751027598355844,1,0.0
irreparably,1,0,0,-0.007751027598355844,1,0.0
lowbrow,4,0,1,-0.023194362889019382,5,2.321928094887362
accent,2,0,0,-0.015443335290663537,2,1.0
unexceptional,0,0,1,0.007574867880211391,1,0.0
dare,0,0,4,0.03047563123899002,4,2.0
emerging,0,0,2,0.015208455666470933,2,1.0
cahill,0,0,1,0.007574867880211391,1,0.0
sessions,1,0,2,0.0075161479741632405,3,1.5849625007211563
luc,0,0,1,0.007574867880211391,1,0.0
jean,0,0,1,0.007574867880211391,1,0.0
godard,0,0,1,0.007574867880211391,1,0.0
torpor,0,0,1,0.007574867880211391,1,0.0
appraisal,0,0,1,0.007574867880211391,1,0.0
astute,1,0,1,-0.0001174398120963021,2,1.0
ridiculously,1,0,1,-0.0001174398120963021,2,1.0
fab,1,0,1,-0.0001174398120963021,2,1.0
souvenir,0,0,1,0.007574867880211391,1,0.0
solely,2,0,1,-0.007809747504403995,3,1.5849625007211563
aggravating,0,0,1,0.007574867880211391,1,0.0
alternately,1,0,2,0.0075161479741632405,3,1.5849625007211563
joyous,0,0,3,0.022842043452730474,3,1.5849625007211563
masterpeice,0,0,1,0.007574867880211391,1,0.0
became,1,0,1,-0.0001174398120963021,2,1.0
ruin,0,0,1,0.007574867880211391,1,0.0
dropped,0,0,1,0.007574867880211391,1,0.0
groupies,1,0,0,-0.007751027598355844,1,0.0
nod,2,0,1,-0.007809747504403995,3,1.5849625007211563
canning,1,0,0,-0.007751027598355844,1,0.0
tweedy,1,0,1,-0.0001174398120963021,2,1.0
nude,1,0,0,-0.007751027598355844,1,0.0
yearn,1,0,0,-0.007751027598355844,1,0.0
airborne,1,0,0,-0.007751027598355844,1,0.0
candidly,0,0,1,0.007574867880211391,1,0.0
commerce,0,0,3,0.022842043452730474,3,1.5849625007211563
raison,0,0,1,0.007574867880211391,1,0.0
être,0,0,1,0.007574867880211391,1,0.0
anemia,0,0,1,0.007574867880211391,1,0.0
inanities,0,0,1,0.007574867880211391,1,0.0
dissection,0,0,1,0.007574867880211391,1,0.0
difficulties,0,0,2,0.015208455666470933,2,1.0
appreciative,0,0,1,0.007574867880211391,1,0.0
fandom,0,0,1,0.007574867880211391,1,0.0
vulnerable,0,0,1,0.007574867880211391,1,0.0
guardedly,0,0,1,0.007574867880211391,1,0.0
unbowed,0,0,1,0.007574867880211391,1,0.0
wealth,0,0,1,0.007574867880211391,1,0.0
priceless,0,0,1,0.007574867880211391,1,0.0
impacts,1,0,1,-0.0001174398120963021,2,1.0
converts,0,0,1,0.007574867880211391,1,0.0
sending,1,0,1,-0.0001174398120963021,2,1.0
reiner,1,0,0,-0.007751027598355844,1,0.0
artifact,1,0,0,-0.007751027598355844,1,0.0
erin,1,0,1,-0.0001174398120963021,2,1.0
nordstrom,0,0,1,0.007574867880211391,1,0.0
natty,0,0,1,0.007574867880211391,1,0.0
enhanced,0,0,1,0.007574867880211391,1,0.0
admirers,0,0,1,0.007574867880211391,1,0.0
tumultuous,0,0,1,0.007574867880211391,1,0.0
brooding,2,0,2,-0.00017615971814445228,4,2.0
murky,1,0,1,-0.0001174398120963021,2,1.0
attraction,8,0,2,-0.04633000587199061,10,3.3219280948873626
timely,0,0,2,0.015208455666470933,2,1.0
mergers,0,0,1,0.007574867880211391,1,0.0
downsizing,0,0,1,0.007574867880211391,1,0.0
collaborative,0,0,1,0.007574867880211391,1,0.0
acolytes,0,0,1,0.007574867880211391,1,0.0
smitten,0,0,1,0.007574867880211391,1,0.0
troubadour,0,0,1,0.007574867880211391,1,0.0
evolve,0,0,1,0.007574867880211391,1,0.0
recalling,0,0,1,0.007574867880211391,1,0.0
handsomely,0,0,1,0.007574867880211391,1,0.0
rockumentary,0,0,1,0.007574867880211391,1,0.0
woven,0,0,1,0.007574867880211391,1,0.0
coffee,2,0,0,-0.015443335290663537,2,1.0
table,2,0,1,-0.007809747504403995,3,1.5849625007211563
import,1,0,0,-0.007751027598355844,1,0.0
sham,1,0,1,-0.0001174398120963021,2,1.0
popularity,1,0,1,-0.0001174398120963021,2,1.0
aspirations,3,0,1,-0.015502055196711688,4,2.0
monotonous,3,0,0,-0.02313564298297123,3,1.5849625007211563
coasting,1,0,0,-0.007751027598355844,1,0.0
roughly,1,0,0,-0.007751027598355844,1,0.0
rank,1,0,0,-0.007751027598355844,1,0.0
praised,1,0,0,-0.007751027598355844,1,0.0
pedestrian,2,0,0,-0.015443335290663537,2,1.0
abound,0,0,1,0.007574867880211391,1,0.0
innuendoes,0,0,1,0.007574867880211391,1,0.0
showboating,1,0,0,-0.007751027598355844,1,0.0
cracker,1,0,0,-0.007751027598355844,1,0.0
distressingly,1,0,0,-0.007751027598355844,1,0.0
spied,1,0,0,-0.007751027598355844,1,0.0
eyea,1,0,0,-0.007751027598355844,1,0.0
extortion,1,0,0,-0.007751027598355844,1,0.0
moviegoing,2,0,2,-0.00017615971814445228,4,2.0
reap,2,0,0,-0.015443335290663537,2,1.0
majority,1,0,2,0.0075161479741632405,3,1.5849625007211563
aggressively,2,0,2,-0.00017615971814445228,4,2.0
partnership,1,0,0,-0.007751027598355844,1,0.0
honed,1,0,0,-0.007751027598355844,1,0.0
shtick,2,0,0,-0.015443335290663537,2,1.0
prima,1,0,0,-0.007751027598355844,1,0.0
donna,1,0,0,-0.007751027598355844,1,0.0
veiled,1,0,0,-0.007751027598355844,1,0.0
avengers,1,0,0,-0.007751027598355844,1,0.0
remakes,1,0,3,0.015149735760422781,4,2.0
anemic,3,0,0,-0.02313564298297123,3,1.5849625007211563
howling,1,0,0,-0.007751027598355844,1,0.0
clunker,2,0,0,-0.015443335290663537,2,1.0
spinoffs,1,0,0,-0.007751027598355844,1,0.0
engendering,2,0,0,-0.015443335290663537,2,1.0
rerun,1,0,0,-0.007751027598355844,1,0.0
halfwit,1,0,0,-0.007751027598355844,1,0.0
standup,2,0,0,-0.015443335290663537,2,1.0
ragged,1,0,1,-0.0001174398120963021,2,1.0
bid,1,0,0,-0.007751027598355844,1,0.0
progenitor,1,0,0,-0.007751027598355844,1,0.0
toy,2,0,0,-0.015443335290663537,2,1.0
balto,1,0,0,-0.007751027598355844,1,0.0
schoolyard,0,0,1,0.007574867880211391,1,0.0
extinct,0,0,1,0.007574867880211391,1,0.0
mammoths,0,0,1,0.007574867880211391,1,0.0
museum,1,0,0,-0.007751027598355844,1,0.0
diverte,1,0,0,-0.007751027598355844,1,0.0
convence,1,0,0,-0.007751027598355844,1,0.0
só,2,0,0,-0.015443335290663537,2,1.0
passatempo,1,0,0,-0.007751027598355844,1,0.0
descompromissado,1,0,0,-0.007751027598355844,1,0.0
gelo,1,0,0,-0.007751027598355844,1,0.0
generically,1,0,0,-0.007751027598355844,1,0.0
monsters,5,0,3,-0.01561949500880799,8,3.0
prehistoric,1,0,1,-0.0001174398120963021,2,1.0
kiddies,1,0,1,-0.0001174398120963021,2,1.0
footing,1,0,0,-0.007751027598355844,1,0.0
spots,1,0,0,-0.007751027598355844,1,0.0
keeper,0,0,1,0.007574867880211391,1,0.0
furry,1,0,0,-0.007751027598355844,1,0.0
lapdance,1,0,0,-0.007751027598355844,1,0.0
breathtaking,0,0,2,0.015208455666470933,2,1.0
lighting,3,0,1,-0.015502055196711688,4,2.0
innovative,2,0,1,-0.007809747504403995,3,1.5849625007211563
pixar,0,0,1,0.007574867880211391,1,0.0
backgrounds,0,0,2,0.015208455666470933,2,1.0
adage,0,0,1,0.007574867880211391,1,0.0
manfred,0,0,1,0.007574867880211391,1,0.0
generated,3,0,1,-0.015502055196711688,4,2.0
delirious,0,0,1,0.007574867880211391,1,0.0
warner,0,0,2,0.015208455666470933,2,1.0
bros,1,0,2,0.0075161479741632405,3,1.5849625007211563
berg,1,0,1,-0.0001174398120963021,2,1.0
ackerman,0,0,1,0.007574867880211391,1,0.0
wedge,1,0,1,-0.0001174398120963021,2,1.0
looney,0,0,1,0.007574867880211391,1,0.0
screenwriters,3,0,2,-0.007868467410452145,5,2.321928094887362
shrek,1,0,1,-0.0001174398120963021,2,1.0
dreamworks,0,0,1,0.007574867880211391,1,0.0
wear,1,0,1,-0.0001174398120963021,2,1.0
banner,0,0,1,0.007574867880211391,1,0.0
tiring,1,0,0,-0.007751027598355844,1,0.0
stretches,0,0,5,0.03810921902524956,5,2.321928094887362
conception,1,0,1,-0.0001174398120963021,2,1.0
offset,0,0,1,0.007574867880211391,1,0.0
intervals,0,0,1,0.007574867880211391,1,0.0
goo,0,0,2,0.015208455666470933,2,1.0
texture,1,0,0,-0.007751027598355844,1,0.0
subzero,1,0,0,-0.007751027598355844,1,0.0
graphics,1,0,1,-0.0001174398120963021,2,1.0
improves,0,0,2,0.015208455666470933,2,1.0
droll,0,0,3,0.022842043452730474,3,1.5849625007211563
hoped,1,0,2,0.0075161479741632405,3,1.5849625007211563
saldanha,1,0,0,-0.007751027598355844,1,0.0
adherence,1,0,0,-0.007751027598355844,1,0.0
steers,2,0,4,0.015091015854374633,6,2.584962500721156
granted,0,0,1,0.007574867880211391,1,0.0
yorkers,1,0,1,-0.0001174398120963021,2,1.0
burr,2,0,1,-0.007809747504403995,3,1.5849625007211563
curls,0,0,1,0.007574867880211391,1,0.0
vaguely,1,0,2,0.0075161479741632405,3,1.5849625007211563
bratty,1,0,0,-0.007751027598355844,1,0.0
culkin,2,0,4,0.015091015854374633,6,2.584962500721156
hindsight,0,0,2,0.015208455666470933,2,1.0
nuance,0,0,2,0.015208455666470933,2,1.0
shield,0,0,1,0.007574867880211391,1,0.0
denizens,0,0,1,0.007574867880211391,1,0.0
streak,1,0,1,-0.0001174398120963021,2,1.0
unexpectedly,0,0,1,0.007574867880211391,1,0.0
blooded,0,0,1,0.007574867880211391,1,0.0
adamant,0,0,1,0.007574867880211391,1,0.0
remind,1,0,1,-0.0001174398120963021,2,1.0
locales,0,0,1,0.007574867880211391,1,0.0
observations,1,0,0,-0.007751027598355844,1,0.0
blank,1,0,0,-0.007751027598355844,1,0.0
putters,1,0,0,-0.007751027598355844,1,0.0
saved,4,0,1,-0.023194362889019382,5,2.321928094887362
emphasizes,2,0,1,-0.007809747504403995,3,1.5849625007211563
virtue,1,0,1,-0.0001174398120963021,2,1.0
woes,0,0,1,0.007574867880211391,1,0.0
cheering,1,0,1,-0.0001174398120963021,2,1.0
satisfies,0,0,4,0.03047563123899002,4,2.0
slashing,0,0,1,0.007574867880211391,1,0.0
audacious,1,0,2,0.0075161479741632405,3,1.5849625007211563
rye,1,0,0,-0.007751027598355844,1,0.0
dyslexia,1,0,0,-0.007751027598355844,1,0.0
salinger,0,0,1,0.007574867880211391,1,0.0
thou,0,0,1,0.007574867880211391,1,0.0
wing,0,0,1,0.007574867880211391,1,0.0
propriety,0,0,1,0.007574867880211391,1,0.0
wayward,1,0,1,-0.0001174398120963021,2,1.0
privileged,0,0,1,0.007574867880211391,1,0.0
dysfunctionally,0,0,1,0.007574867880211391,1,0.0
gryffindor,1,0,0,-0.007751027598355844,1,0.0
strikingly,0,0,1,0.007574867880211391,1,0.0
disaffected,0,0,1,0.007574867880211391,1,0.0
rueful,0,0,1,0.007574867880211391,1,0.0
errant,0,0,1,0.007574867880211391,1,0.0
outraged,0,0,1,0.007574867880211391,1,0.0
lad,0,0,2,0.015208455666470933,2,1.0
shed,0,0,1,0.007574867880211391,1,0.0
treading,1,0,1,-0.0001174398120963021,2,1.0
appalled,0,0,1,0.007574867880211391,1,0.0
satisfaction,1,0,0,-0.007751027598355844,1,0.0
possess,0,0,1,0.007574867880211391,1,0.0
sorrowfully,0,0,1,0.007574867880211391,1,0.0
surveys,1,0,1,-0.0001174398120963021,2,1.0
scarily,0,0,1,0.007574867880211391,1,0.0
kieran,0,0,2,0.015208455666470933,2,1.0
blisteringly,0,0,2,0.015208455666470933,2,1.0
skewed,0,0,1,0.007574867880211391,1,0.0
kinetic,0,0,2,0.015208455666470933,2,1.0
aimlessly,1,0,1,-0.0001174398120963021,2,1.0
befitting,0,0,1,0.007574867880211391,1,0.0
crashes,0,0,1,0.007574867880211391,1,0.0
sarandon,0,0,2,0.015208455666470933,2,1.0
philippe,0,0,1,0.007574867880211391,1,0.0
triumphs,0,0,1,0.007574867880211391,1,0.0
floundering,0,0,1,0.007574867880211391,1,0.0
juicy,0,0,1,0.007574867880211391,1,0.0
plethora,0,0,1,0.007574867880211391,1,0.0
irritatingly,1,0,1,-0.0001174398120963021,2,1.0
quip,0,0,1,0.007574867880211391,1,0.0
solipsistic,0,0,1,0.007574867880211391,1,0.0
deviously,1,0,0,-0.007751027598355844,1,0.0
adopts,1,0,0,-0.007751027598355844,1,0.0
guise,1,0,0,-0.007751027598355844,1,0.0
generates,0,0,1,0.007574867880211391,1,0.0
ghoulish,1,0,1,-0.0001174398120963021,2,1.0
fascination,1,0,1,-0.0001174398120963021,2,1.0
detracts,1,0,0,-0.007751027598355844,1,0.0
runner,3,0,3,-0.0002348796241926042,6,2.584962500721156
uhf,1,0,0,-0.007751027598355844,1,0.0
blade,4,0,2,-0.015560775102759838,6,2.584962500721156
starters,1,0,0,-0.007751027598355844,1,0.0
evaporation,1,0,0,-0.007751027598355844,1,0.0
filler,1,0,1,-0.0001174398120963021,2,1.0
urgency,1,0,2,0.0075161479741632405,3,1.5849625007211563
imposter,2,0,0,-0.015443335290663537,2,1.0
disposable,4,0,2,-0.015560775102759838,6,2.584962500721156
attackers,1,0,0,-0.007751027598355844,1,0.0
evade,1,0,0,-0.007751027598355844,1,0.0
technologies,1,0,0,-0.007751027598355844,1,0.0
surveillance,1,0,0,-0.007751027598355844,1,0.0
tunnels,1,0,0,-0.007751027598355844,1,0.0
anonymous,1,0,1,-0.0001174398120963021,2,1.0
persnickety,0,0,1,0.007574867880211391,1,0.0
shrugging,0,0,2,0.015208455666470933,2,1.0
ballast,1,0,1,-0.0001174398120963021,2,1.0
fleder,1,0,0,-0.007751027598355844,1,0.0
succumbs,2,0,0,-0.015443335290663537,2,1.0
skills,3,0,0,-0.02313564298297123,3,1.5849625007211563
arising,1,0,0,-0.007751027598355844,1,0.0
hawking,1,0,0,-0.007751027598355844,1,0.0
splendour,1,0,0,-0.007751027598355844,1,0.0
theatrical,3,0,0,-0.02313564298297123,3,1.5849625007211563
grave,5,0,0,-0.038520258367586616,5,2.321928094887362
introduce,1,0,0,-0.007751027598355844,1,0.0
sinise,1,0,0,-0.007751027598355844,1,0.0
screeching,2,0,0,-0.015443335290663537,2,1.0
donuts,1,0,0,-0.007751027598355844,1,0.0
phillip,1,0,0,-0.007751027598355844,1,0.0
padding,3,0,0,-0.02313564298297123,3,1.5849625007211563
ordinances,1,0,0,-0.007751027598355844,1,0.0
zoning,1,0,0,-0.007751027598355844,1,0.0
fugitive,1,0,0,-0.007751027598355844,1,0.0
amalgam,2,0,0,-0.015443335290663537,2,1.0
template,1,0,1,-0.0001174398120963021,2,1.0
feeder,1,0,0,-0.007751027598355844,1,0.0
blur,1,0,1,-0.0001174398120963021,2,1.0
distracting,1,0,0,-0.007751027598355844,1,0.0
thoughtlessly,1,0,0,-0.007751027598355844,1,0.0
successor,0,0,1,0.007574867880211391,1,0.0
automatically,2,0,0,-0.015443335290663537,2,1.0
pegs,1,0,0,-0.007751027598355844,1,0.0
harrison,2,0,0,-0.015443335290663537,2,1.0
sabrina,1,0,0,-0.007751027598355844,1,0.0
insomnia,1,0,9,0.06095126247798004,10,3.3219280948873626
nolan,0,0,6,0.0457428068115091,6,2.584962500721156
registers,0,0,1,0.007574867880211391,1,0.0
complements,0,0,1,0.007574867880211391,1,0.0
ambiguity,0,0,1,0.007574867880211391,1,0.0
delve,0,0,1,0.007574867880211391,1,0.0
bravely,0,0,1,0.007574867880211391,1,0.0
ambivalence,0,0,1,0.007574867880211391,1,0.0
surrendering,0,0,1,0.007574867880211391,1,0.0
traditionally,0,0,2,0.015208455666470933,2,1.0
swords,0,0,1,0.007574867880211391,1,0.0
composure,0,0,1,0.007574867880211391,1,0.0
helm,1,0,1,-0.0001174398120963021,2,1.0
lends,1,0,3,0.015149735760422781,4,2.0
cerebral,0,0,1,0.007574867880211391,1,0.0
cinemantic,0,0,1,0.007574867880211391,1,0.0
undercurrent,0,0,1,0.007574867880211391,1,0.0
penetrating,0,0,1,0.007574867880211391,1,0.0
elect,0,0,1,0.007574867880211391,1,0.0
imposed,0,0,1,0.007574867880211391,1,0.0
sake,1,0,2,0.0075161479741632405,3,1.5849625007211563
últimos,0,0,1,0.007574867880211391,1,0.0
policiales,0,0,1,0.007574867880211391,1,0.0
tiempos,0,0,1,0.007574867880211391,1,0.0
upping,0,0,1,0.007574867880211391,1,0.0
ante,0,0,1,0.007574867880211391,1,0.0
avoids,1,0,0,-0.007751027598355844,1,0.0
studiously,1,0,0,-0.007751027598355844,1,0.0
jockey,0,0,1,0.007574867880211391,1,0.0
spotlight,0,0,1,0.007574867880211391,1,0.0
awake,0,0,3,0.022842043452730474,3,1.5849625007211563
deprived,0,0,1,0.007574867880211391,1,0.0
dormer,0,0,1,0.007574867880211391,1,0.0
existential,0,0,1,0.007574867880211391,1,0.0
increasing,0,0,1,0.007574867880211391,1,0.0
weariness,0,0,1,0.007574867880211391,1,0.0
physical,0,0,2,0.015208455666470933,2,1.0
surrenders,0,0,2,0.015208455666470933,2,1.0
psychologically,1,0,1,-0.0001174398120963021,2,1.0
sanded,0,0,1,0.007574867880211391,1,0.0
darned,0,0,4,0.03047563123899002,4,2.0
confines,0,0,1,0.007574867880211391,1,0.0
artful,0,0,3,0.022842043452730474,3,1.5849625007211563
eclipse,0,0,1,0.007574867880211391,1,0.0
loathing,0,0,1,0.007574867880211391,1,0.0
adrenalin,0,0,2,0.015208455666470933,2,1.0
preconceived,0,0,1,0.007574867880211391,1,0.0
procedural,2,0,1,-0.007809747504403995,3,1.5849625007211563
poised,1,0,1,-0.0001174398120963021,2,1.0
integrated,0,0,1,0.007574867880211391,1,0.0
perceptions,0,0,1,0.007574867880211391,1,0.0
zzzzzzzzz,1,0,0,-0.007751027598355844,1,0.0
hmmmmm,1,0,0,-0.007751027598355844,1,0.0
psycho,1,0,0,-0.007751027598355844,1,0.0
hitchcockian,0,0,3,0.022842043452730474,3,1.5849625007211563
tingle,0,0,2,0.015208455666470933,2,1.0
senses,0,0,2,0.015208455666470933,2,1.0
laddish,1,0,0,-0.007751027598355844,1,0.0
geeks,1,0,0,-0.007751027598355844,1,0.0
sideshow,1,0,0,-0.007751027598355844,1,0.0
keening,1,0,0,-0.007751027598355844,1,0.0
mutilating,1,0,0,-0.007751027598355844,1,0.0
symptom,1,0,0,-0.007751027598355844,1,0.0
partyhow,1,0,0,-0.007751027598355844,1,0.0
gross,7,0,0,-0.053904873752202,7,2.807354922057604
rating,2,0,0,-0.015443335290663537,2,1.0
diss,1,0,0,-0.007751027598355844,1,0.0
grossest,0,0,1,0.007574867880211391,1,0.0
candid,1,0,1,-0.0001174398120963021,2,1.0
sade,1,0,0,-0.007751027598355844,1,0.0
marquis,1,0,0,-0.007751027598355844,1,0.0
bam,0,0,2,0.015208455666470933,2,1.0
margera,0,0,1,0.007574867880211391,1,0.0
conning,0,0,1,0.007574867880211391,1,0.0
pretending,0,0,1,0.007574867880211391,1,0.0
alligator,0,0,2,0.015208455666470933,2,1.0
grunting,0,0,1,0.007574867880211391,1,0.0
upheaval,1,0,0,-0.007751027598355844,1,0.0
assaults,1,0,0,-0.007751027598355844,1,0.0
sanctimony,3,0,0,-0.02313564298297123,3,1.5849625007211563
skunk,1,0,0,-0.007751027598355844,1,0.0
doltish,1,0,0,-0.007751027598355844,1,0.0
downright,3,0,1,-0.015502055196711688,4,2.0
odor,2,0,0,-0.015443335290663537,2,1.0
methamphetamines,0,0,1,0.007574867880211391,1,0.0
única,1,0,0,-0.007751027598355844,1,0.0
mau,1,0,0,-0.007751027598355844,1,0.0
longo,1,0,0,-0.007751027598355844,1,0.0
teve,1,0,0,-0.007751027598355844,1,0.0
cinemas,1,0,0,-0.007751027598355844,1,0.0
mais,1,0,2,0.0075161479741632405,3,1.5849625007211563
programa,1,0,0,-0.007751027598355844,1,0.0
episódio,1,0,0,-0.007751027598355844,1,0.0
gosto,1,0,0,-0.007751027598355844,1,0.0
diferença,1,0,0,-0.007751027598355844,1,0.0
exibi,1,0,0,-0.007751027598355844,1,0.0
erotic,1,0,1,-0.0001174398120963021,2,1.0
showand,0,0,1,0.007574867880211391,1,0.0
embarrassed,0,0,2,0.015208455666470933,2,1.0
cattle,0,0,1,0.007574867880211391,1,0.0
prod,0,0,1,0.007574867880211391,1,0.0
jolts,0,0,1,0.007574867880211391,1,0.0
marveling,1,0,0,-0.007751027598355844,1,0.0
cogent,1,0,0,-0.007751027598355844,1,0.0
withstand,1,0,0,-0.007751027598355844,1,0.0
mount,1,0,0,-0.007751027598355844,1,0.0
superhuman,1,0,0,-0.007751027598355844,1,0.0
wincing,1,0,0,-0.007751027598355844,1,0.0
repugnance,1,0,0,-0.007751027598355844,1,0.0
burrito,1,0,0,-0.007751027598355844,1,0.0
tequila,1,0,0,-0.007751027598355844,1,0.0
bender,1,0,1,-0.0001174398120963021,2,1.0
headed,1,0,1,-0.0001174398120963021,2,1.0
dosage,0,0,1,0.007574867880211391,1,0.0
goofball,1,0,2,0.0075161479741632405,3,1.5849625007211563
shorn,1,0,0,-0.007751027598355844,1,0.0
grotesque,1,0,1,-0.0001174398120963021,2,1.0
repulsive,1,0,1,-0.0001174398120963021,2,1.0
heaps,0,0,1,0.007574867880211391,1,0.0
sickening,1,0,1,-0.0001174398120963021,2,1.0
steaming,0,0,1,0.007574867880211391,1,0.0
rendition,0,0,1,0.007574867880211391,1,0.0
category,3,0,2,-0.007868467410452145,5,2.321928094887362
tasteless,2,0,0,-0.015443335290663537,2,1.0
projectile,1,0,0,-0.007751027598355844,1,0.0
welt,1,0,0,-0.007751027598355844,1,0.0
riot,2,0,1,-0.007809747504403995,3,1.5849625007211563
jackasses,2,0,0,-0.015443335290663537,2,1.0
plotless,2,0,1,-0.007809747504403995,3,1.5849625007211563
admitted,0,0,1,0.007574867880211391,1,0.0
dadaist,0,0,1,0.007574867880211391,1,0.0
humorless,1,0,2,0.0075161479741632405,3,1.5849625007211563
expansion,1,0,0,-0.007751027598355844,1,0.0
injuries,1,0,0,-0.007751027598355844,1,0.0
unencouraging,1,0,0,-0.007751027598355844,1,0.0
threefold,1,0,0,-0.007751027598355844,1,0.0
pranks,2,0,0,-0.015443335290663537,2,1.0
dimwits,1,0,0,-0.007751027598355844,1,0.0
dares,1,0,1,-0.0001174398120963021,2,1.0
bump,1,0,2,0.0075161479741632405,3,1.5849625007211563
sputter,0,0,1,0.007574867880211391,1,0.0
propaganda,2,0,1,-0.007809747504403995,3,1.5849625007211563
bankrupt,1,0,0,-0.007751027598355844,1,0.0
rises,5,0,0,-0.038520258367586616,5,2.321928094887362
potshots,1,0,0,-0.007751027598355844,1,0.0
frustration,2,0,1,-0.007809747504403995,3,1.5849625007211563
overcomes,1,0,2,0.0075161479741632405,3,1.5849625007211563
envelops,0,0,1,0.007574867880211391,1,0.0
heartstring,1,0,0,-0.007751027598355844,1,0.0
unplundered,1,0,0,-0.007751027598355844,1,0.0
untugged,1,0,0,-0.007751027598355844,1,0.0
address,0,0,1,0.007574867880211391,1,0.0
health,2,0,0,-0.015443335290663537,2,1.0
condone,1,0,0,-0.007751027598355844,1,0.0
comment,1,0,0,-0.007751027598355844,1,0.0
tortuous,1,0,0,-0.007751027598355844,1,0.0
schizophrenia,1,0,0,-0.007751027598355844,1,0.0
choke,1,0,0,-0.007751027598355844,1,0.0
yank,1,0,0,-0.007751027598355844,1,0.0
simpsons,1,0,0,-0.007751027598355844,1,0.0
stocked,1,0,0,-0.007751027598355844,1,0.0
technicians,0,0,1,0.007574867880211391,1,0.0
elevate,0,0,2,0.015208455666470933,2,1.0
pedestal,2,0,0,-0.015443335290663537,2,1.0
unturned,2,0,0,-0.015443335290663537,2,1.0
aggrieved,1,0,0,-0.007751027598355844,1,0.0
underscoring,1,0,0,-0.007751027598355844,1,0.0
philosophically,1,0,0,-0.007751027598355844,1,0.0
logistically,1,0,0,-0.007751027598355844,1,0.0
scripted,3,0,0,-0.02313564298297123,3,1.5849625007211563
unfolding,1,0,1,-0.0001174398120963021,2,1.0
spread,1,0,0,-0.007751027598355844,1,0.0
forgets,1,0,0,-0.007751027598355844,1,0.0
fisted,2,0,0,-0.015443335290663537,2,1.0
lionize,1,0,0,-0.007751027598355844,1,0.0
ham,2,0,1,-0.007809747504403995,3,1.5849625007211563
sermon,1,0,0,-0.007751027598355844,1,0.0
overwrought,2,0,0,-0.015443335290663537,2,1.0
parodied,1,0,0,-0.007751027598355844,1,0.0
coarse,2,0,0,-0.015443335290663537,2,1.0
didactic,3,0,0,-0.02313564298297123,3,1.5849625007211563
deaf,1,0,0,-0.007751027598355844,1,0.0
behalf,1,0,0,-0.007751027598355844,1,0.0
appearing,2,0,0,-0.015443335290663537,2,1.0
reaffirming,0,0,1,0.007574867880211391,1,0.0
complexities,1,0,0,-0.007751027598355844,1,0.0
bromides,1,0,0,-0.007751027598355844,1,0.0
slogans,1,0,0,-0.007751027598355844,1,0.0
chump,1,0,0,-0.007751027598355844,1,0.0
waited,0,0,1,0.007574867880211391,1,0.0
bed,0,0,3,0.022842043452730474,3,1.5849625007211563
musicals,1,0,0,-0.007751027598355844,1,0.0
specifically,1,0,0,-0.007751027598355844,1,0.0
expounded,1,0,0,-0.007751027598355844,1,0.0
feely,1,0,0,-0.007751027598355844,1,0.0
promotes,1,0,1,-0.0001174398120963021,2,1.0
touchy,1,0,0,-0.007751027598355844,1,0.0
underrated,0,0,2,0.015208455666470933,2,1.0
folly,1,0,1,-0.0001174398120963021,2,1.0
occasional,1,0,3,0.015149735760422781,4,2.0
format,0,0,1,0.007574867880211391,1,0.0
chesterton,0,0,1,0.007574867880211391,1,0.0
christianity,0,0,1,0.007574867880211391,1,0.0
biblical,1,0,1,-0.0001174398120963021,2,1.0
lessen,2,0,0,-0.015443335290663537,2,1.0
brussels,0,0,1,0.007574867880211391,1,0.0
appetizing,0,0,1,0.007574867880211391,1,0.0
veggietales,0,0,2,0.015208455666470933,2,1.0
sprouts,0,0,1,0.007574867880211391,1,0.0
eat,2,0,3,0.0074574280681150885,5,2.321928094887362
asparagus,0,0,1,0.007574867880211391,1,0.0
inchoate,1,0,0,-0.007751027598355844,1,0.0
thrusts,1,0,0,-0.007751027598355844,1,0.0
eldritch,1,0,0,-0.007751027598355844,1,0.0
remained,1,0,0,-0.007751027598355844,1,0.0
themed,0,0,3,0.022842043452730474,3,1.5849625007211563
wary,0,0,1,0.007574867880211391,1,0.0
strips,0,0,1,0.007574867880211391,1,0.0
sanctimoniousness,0,0,1,0.007574867880211391,1,0.0
meaningful,0,0,2,0.015208455666470933,2,1.0
bible,0,0,1,0.007574867880211391,1,0.0
educational,0,0,2,0.015208455666470933,2,1.0
stitch,0,0,2,0.015208455666470933,2,1.0
escort,0,0,2,0.015208455666470933,2,1.0
catchy,0,0,2,0.015208455666470933,2,1.0
forgiveness,0,0,2,0.015208455666470933,2,1.0
allow,0,0,1,0.007574867880211391,1,0.0
youngsters,1,0,2,0.0075161479741632405,3,1.5849625007211563
medicine,0,0,1,0.007574867880211391,1,0.0
comprehend,1,0,0,-0.007751027598355844,1,0.0
lunacy,1,0,1,-0.0001174398120963021,2,1.0
pronounced,0,0,1,0.007574867880211391,1,0.0
agnostic,0,0,1,0.007574867880211391,1,0.0
carnivore,0,0,1,0.007574867880211391,1,0.0
pythonesque,0,0,1,0.007574867880211391,1,0.0
manifestations,1,0,0,-0.007751027598355844,1,0.0
veggie,1,0,0,-0.007751027598355844,1,0.0
threshold,1,0,0,-0.007751027598355844,1,0.0
delighted,1,0,1,-0.0001174398120963021,2,1.0
devilish,0,0,1,0.007574867880211391,1,0.0
theology,1,0,1,-0.0001174398120963021,2,1.0
center,1,0,2,0.0075161479741632405,3,1.5849625007211563
espoused,0,0,1,0.007574867880211391,1,0.0
consistent,2,0,1,-0.007809747504403995,3,1.5849625007211563
batch,0,0,1,0.007574867880211391,1,0.0
vegetables,0,0,1,0.007574867880211391,1,0.0
spinach,0,0,1,0.007574867880211391,1,0.0
tasting,0,0,1,0.007574867880211391,1,0.0
accompanies,1,0,0,-0.007751027598355844,1,0.0
obscurities,0,0,1,0.007574867880211391,1,0.0
smacks,1,0,1,-0.0001174398120963021,2,1.0
critic,1,0,1,-0.0001174398120963021,2,1.0
reviewing,0,0,1,0.007574867880211391,1,0.0
unreligious,0,0,1,0.007574867880211391,1,0.0
screenings,1,0,1,-0.0001174398120963021,2,1.0
amuse,0,0,3,0.022842043452730474,3,1.5849625007211563
sprightly,0,0,2,0.015208455666470933,2,1.0
megaplex,0,0,1,0.007574867880211391,1,0.0
resolutely,2,0,2,-0.00017615971814445228,4,2.0
sufficiently,0,0,1,0.007574867880211391,1,0.0
awhile,1,0,0,-0.007751027598355844,1,0.0
wilts,1,0,0,-0.007751027598355844,1,0.0
choice,2,0,4,0.015091015854374633,6,2.584962500721156
kaleidoscope,1,0,0,-0.007751027598355844,1,0.0
naptime,1,0,0,-0.007751027598355844,1,0.0
thekids,1,0,0,-0.007751027598355844,1,0.0
negative,1,0,0,-0.007751027598355844,1,0.0
burn,2,0,0,-0.015443335290663537,2,1.0
wewannour,1,0,0,-0.007751027598355844,1,0.0
writingand,1,0,0,-0.007751027598355844,1,0.0
sooooo,1,0,0,-0.007751027598355844,1,0.0
tootsie,3,0,0,-0.02313564298297123,3,1.5849625007211563
knockoff,2,0,0,-0.015443335290663537,2,1.0
vibe,1,0,0,-0.007751027598355844,1,0.0
requisite,2,0,0,-0.015443335290663537,2,1.0
hotter,1,0,0,-0.007751027598355844,1,0.0
faux,2,0,0,-0.015443335290663537,2,1.0
references,1,0,2,0.0075161479741632405,3,1.5849625007211563
thousand,1,0,1,-0.0001174398120963021,2,1.0
imply,1,0,0,-0.007751027598355844,1,0.0
shockingly,3,0,0,-0.02313564298297123,3,1.5849625007211563
milking,1,0,0,-0.007751027598355844,1,0.0
travesty,1,0,0,-0.007751027598355844,1,0.0
transvestite,1,0,0,-0.007751027598355844,1,0.0
montage,1,0,0,-0.007751027598355844,1,0.0
fidget,1,0,0,-0.007751027598355844,1,0.0
deleted,1,0,0,-0.007751027598355844,1,0.0
doa,2,0,0,-0.015443335290663537,2,1.0
sportsmanship,1,0,0,-0.007751027598355844,1,0.0
stiflingly,1,0,0,-0.007751027598355844,1,0.0
staggeringly,1,0,1,-0.0001174398120963021,2,1.0
bending,0,0,2,0.015208455666470933,2,1.0
bra,1,0,0,-0.007751027598355844,1,0.0
caretakers,1,0,0,-0.007751027598355844,1,0.0
teachers,1,0,0,-0.007751027598355844,1,0.0
unsurprisingly,1,0,0,-0.007751027598355844,1,0.0
push,2,0,2,-0.00017615971814445228,4,2.0
grinder,1,0,0,-0.007751027598355844,1,0.0
hardwood,1,0,0,-0.007751027598355844,1,0.0
outcome,1,0,0,-0.007751027598355844,1,0.0
globetrotters,1,0,0,-0.007751027598355844,1,0.0
generals,1,0,0,-0.007751027598355844,1,0.0
cluelessness,1,0,0,-0.007751027598355844,1,0.0
earnestness,2,0,3,0.0074574280681150885,5,2.321928094887362
tang,1,0,1,-0.0001174398120963021,2,1.0
pootie,1,0,1,-0.0001174398120963021,2,1.0
punchlines,1,0,0,-0.007751027598355844,1,0.0
cameos,1,0,1,-0.0001174398120963021,2,1.0
wattage,1,0,0,-0.007751027598355844,1,0.0
stunningly,0,0,1,0.007574867880211391,1,0.0
misguided,1,0,0,-0.007751027598355844,1,0.0
devote,1,0,0,-0.007751027598355844,1,0.0
capably,1,0,0,-0.007751027598355844,1,0.0
neeson,1,0,1,-0.0001174398120963021,2,1.0
lightness,0,0,1,0.007574867880211391,1,0.0
kathryn,0,0,1,0.007574867880211391,1,0.0
coating,0,0,2,0.015208455666470933,2,1.0
bigelow,1,0,5,0.030416911332941866,6,2.584962500721156
unrelentingly,1,0,1,-0.0001174398120963021,2,1.0
interludes,1,0,1,-0.0001174398120963021,2,1.0
alas,1,0,0,-0.007751027598355844,1,0.0
breadth,1,0,1,-0.0001174398120963021,2,1.0
propels,0,0,1,0.007574867880211391,1,0.0
echelons,0,0,1,0.007574867880211391,1,0.0
terrifically,0,0,2,0.015208455666470933,2,1.0
tanks,1,0,0,-0.007751027598355844,1,0.0
milks,1,0,1,-0.0001174398120963021,2,1.0
evenly,1,0,0,-0.007751027598355844,1,0.0
handles,1,0,1,-0.0001174398120963021,2,1.0
interesante,0,0,1,0.007574867880211391,1,0.0
estadounidense,0,0,1,0.007574867880211391,1,0.0
elemento,0,0,1,0.007574867880211391,1,0.0
prescinde,0,0,1,0.007574867880211391,1,0.0
manipulador,0,0,1,0.007574867880211391,1,0.0
trabajo,0,0,1,0.007574867880211391,1,0.0
disfrutable,0,0,1,0.007574867880211391,1,0.0
clásico,0,0,2,0.015208455666470933,2,1.0
gracias,0,0,1,0.007574867880211391,1,0.0
patriotero,0,0,1,0.007574867880211391,1,0.0
nosedive,1,0,1,-0.0001174398120963021,2,1.0
widowmaker,1,0,2,0.0075161479741632405,3,1.5849625007211563
enveloped,1,0,0,-0.007751027598355844,1,0.0
dedication,1,0,0,-0.007751027598355844,1,0.0
jettisoned,1,0,1,-0.0001174398120963021,2,1.0
par,0,0,2,0.015208455666470933,2,1.0
boot,0,0,2,0.015208455666470933,2,1.0
petersen,0,0,1,0.007574867880211391,1,0.0
das,0,0,2,0.015208455666470933,2,1.0
wolfgang,0,0,1,0.007574867880211391,1,0.0
conflicted,0,0,2,0.015208455666470933,2,1.0
crafting,0,0,1,0.007574867880211391,1,0.0
khan,1,0,1,-0.0001174398120963021,2,1.0
trek,8,0,6,-0.015795654726952442,14,3.8073549220576037
spock,1,0,0,-0.007751027598355844,1,0.0
wrath,1,0,1,-0.0001174398120963021,2,1.0
clenched,0,0,1,0.007574867880211391,1,0.0
sustained,2,0,2,-0.00017615971814445228,4,2.0
bombastic,1,0,1,-0.0001174398120963021,2,1.0
demons,1,0,1,-0.0001174398120963021,2,1.0
confronting,0,0,1,0.007574867880211391,1,0.0
dicey,1,0,0,-0.007751027598355844,1,0.0
uncertainty,0,0,1,0.007574867880211391,1,0.0
epilogue,0,0,1,0.007574867880211391,1,0.0
russia,0,0,1,0.007574867880211391,1,0.0
soviet,0,0,1,0.007574867880211391,1,0.0
sacrifice,0,0,2,0.015208455666470933,2,1.0
ryanovich,1,0,0,-0.007751027598355844,1,0.0
elegiacally,1,0,0,-0.007751027598355844,1,0.0
favorably,0,0,1,0.007574867880211391,1,0.0
eh,1,0,0,-0.007751027598355844,1,0.0
porn,1,0,2,0.0075161479741632405,3,1.5849625007211563
palma,1,0,0,-0.007751027598355844,1,0.0
brian,2,0,0,-0.015443335290663537,2,1.0
fundamentally,1,0,0,-0.007751027598355844,1,0.0
achieves,5,0,4,-0.007985907222548445,9,3.1699250014423126
grandeur,1,0,4,0.022783323546682326,5,2.321928094887362
miscast,1,0,0,-0.007751027598355844,1,0.0
softly,1,0,0,-0.007751027598355844,1,0.0
firmly,3,0,1,-0.015502055196711688,4,2.0
triste,1,0,0,-0.007751027598355844,1,0.0
decirles,1,0,0,-0.007751027598355844,1,0.0
desnudo,1,0,0,-0.007751027598355844,1,0.0
único,1,0,0,-0.007751027598355844,1,0.0
heather,1,0,1,-0.0001174398120963021,2,1.0
cuerpo,1,0,0,-0.007751027598355844,1,0.0
tener,1,0,0,-0.007751027598355844,1,0.0
grato,1,0,0,-0.007751027598355844,1,0.0
fluidity,1,0,0,-0.007751027598355844,1,0.0
loaded,2,0,0,-0.015443335290663537,2,1.0
chen,1,0,0,-0.007751027598355844,1,0.0
kaige,1,0,0,-0.007751027598355844,1,0.0
selection,2,0,1,-0.007809747504403995,3,1.5849625007211563
sufficient,1,0,0,-0.007751027598355844,1,0.0
illuminating,0,0,1,0.007574867880211391,1,0.0
controlling,0,0,2,0.015208455666470933,2,1.0
seesawed,0,0,1,0.007574867880211391,1,0.0
83,0,0,1,0.007574867880211391,1,0.0
culmination,0,0,1,0.007574867880211391,1,0.0
divide,0,0,1,0.007574867880211391,1,0.0
generational,0,0,1,0.007574867880211391,1,0.0
fulfills,0,0,2,0.015208455666470933,2,1.0
facet,2,0,1,-0.007809747504403995,3,1.5849625007211563
rehearsals,0,0,1,0.007574867880211391,1,0.0
oil,0,0,1,0.007574867880211391,1,0.0
compatible,0,0,1,0.007574867880211391,1,0.0
aesthetic,0,0,2,0.015208455666470933,2,1.0
discursive,0,0,1,0.007574867880211391,1,0.0
resists,0,0,1,0.007574867880211391,1,0.0
deft,0,0,5,0.03810921902524956,5,2.321928094887362
strokes,0,0,1,0.007574867880211391,1,0.0
combination,2,0,3,0.0074574280681150885,5,2.321928094887362
bollywood,0,0,1,0.007574867880211391,1,0.0
gulzar,0,0,1,0.007574867880211391,1,0.0
singh,0,0,1,0.007574867880211391,1,0.0
india,0,0,1,0.007574867880211391,1,0.0
jagjit,0,0,1,0.007574867880211391,1,0.0
undermines,1,0,0,-0.007751027598355844,1,0.0
ish,1,0,1,-0.0001174398120963021,2,1.0
renewal,1,0,0,-0.007751027598355844,1,0.0
lethargically,1,0,0,-0.007751027598355844,1,0.0
priggish,1,0,0,-0.007751027598355844,1,0.0
departure,1,0,4,0.022783323546682326,5,2.321928094887362
gloss,3,0,0,-0.02313564298297123,3,1.5849625007211563
flows,1,0,0,-0.007751027598355844,1,0.0
hideous,1,0,0,-0.007751027598355844,1,0.0
yellow,2,0,1,-0.007809747504403995,3,1.5849625007211563
searcher,0,0,1,0.007574867880211391,1,0.0
angelina,0,0,2,0.015208455666470933,2,1.0
dummies,0,0,1,0.007574867880211391,1,0.0
wrongs,0,0,1,0.007574867880211391,1,0.0
burnsthis,0,0,1,0.007574867880211391,1,0.0
conformity,0,0,1,0.007574867880211391,1,0.0
girly,0,0,1,0.007574867880211391,1,0.0
rainy,0,0,1,0.007574867880211391,1,0.0
individual,1,0,0,-0.007751027598355844,1,0.0
prophet,1,0,0,-0.007751027598355844,1,0.0
wine,0,0,1,0.007574867880211391,1,0.0
bottles,0,0,1,0.007574867880211391,1,0.0
piquant,0,0,1,0.007574867880211391,1,0.0
delightfully,0,0,3,0.022842043452730474,3,1.5849625007211563
herek,0,0,1,0.007574867880211391,1,0.0
pour,0,0,1,0.007574867880211391,1,0.0
platinum,1,0,0,-0.007751027598355844,1,0.0
blonde,3,0,2,-0.007868467410452145,5,2.321928094887362
frittered,1,0,0,-0.007751027598355844,1,0.0
unwise,1,0,0,-0.007751027598355844,1,0.0
vibes,1,0,0,-0.007751027598355844,1,0.0
vanishes,1,0,0,-0.007751027598355844,1,0.0
lips,1,0,0,-0.007751027598355844,1,0.0
splash,1,0,0,-0.007751027598355844,1,0.0
possibility,4,0,0,-0.030827950675278923,4,2.0
meaningless,4,0,0,-0.030827950675278923,4,2.0
crock,1,0,0,-0.007751027598355844,1,0.0
elbows,1,0,1,-0.0001174398120963021,2,1.0
ungainly,1,0,0,-0.007751027598355844,1,0.0
knees,1,0,0,-0.007751027598355844,1,0.0
puddle,1,0,0,-0.007751027598355844,1,0.0
galled,1,0,0,-0.007751027598355844,1,0.0
equation,1,0,2,0.0075161479741632405,3,1.5849625007211563
cloaks,1,0,0,-0.007751027598355844,1,0.0
duds,1,0,0,-0.007751027598355844,1,0.0
misery,2,0,0,-0.015443335290663537,2,1.0
dewy,1,0,1,-0.0001174398120963021,2,1.0
scooter,1,0,0,-0.007751027598355844,1,0.0
motorized,1,0,0,-0.007751027598355844,1,0.0
eyed,1,0,1,-0.0001174398120963021,2,1.0
schultz,0,0,1,0.007574867880211391,1,0.0
evocative,1,0,4,0.022783323546682326,5,2.321928094887362
dots,0,0,1,0.007574867880211391,1,0.0
wow,4,0,6,0.014973576042278329,10,3.3219280948873626
lil,2,0,3,0.0074574280681150885,5,2.321928094887362
jordan,3,0,2,-0.007868467410452145,5,2.321928094887362
jealous,0,0,1,0.007574867880211391,1,0.0
naïve,0,0,1,0.007574867880211391,1,0.0
harmlessly,0,0,1,0.007574867880211391,1,0.0
olds,1,0,1,-0.0001174398120963021,2,1.0
agreeable,0,0,1,0.007574867880211391,1,0.0
echoes,1,0,0,-0.007751027598355844,1,0.0
glover,1,0,0,-0.007751027598355844,1,0.0
weirdo,1,0,0,-0.007751027598355844,1,0.0
annie,1,0,0,-0.007751027598355844,1,0.0
screwing,1,0,0,-0.007751027598355844,1,0.0
crispin,1,0,0,-0.007751027598355844,1,0.0
excluding,0,0,1,0.007574867880211391,1,0.0
efficient,1,0,4,0.022783323546682326,5,2.321928094887362
forster,1,0,1,-0.0001174398120963021,2,1.0
meara,1,0,1,-0.0001174398120963021,2,1.0
namesake,0,0,1,0.007574867880211391,1,0.0
tangy,0,0,1,0.007574867880211391,1,0.0
recycling,0,0,1,0.007574867880211391,1,0.0
tweak,0,0,1,0.007574867880211391,1,0.0
wholesome,0,0,3,0.022842043452730474,3,1.5849625007211563
raises,1,0,3,0.015149735760422781,4,2.0
affable,1,0,2,0.0075161479741632405,3,1.5849625007211563
preteen,0,0,1,0.007574867880211391,1,0.0
worship,0,0,1,0.007574867880211391,1,0.0
eugene,1,0,0,-0.007751027598355844,1,0.0
veljohnson,1,0,0,-0.007751027598355844,1,0.0
laziness,1,0,1,-0.0001174398120963021,2,1.0
reginald,3,0,0,-0.02313564298297123,3,1.5849625007211563
exalted,1,0,0,-0.007751027598355844,1,0.0
aspire,1,0,0,-0.007751027598355844,1,0.0
uninventive,1,0,0,-0.007751027598355844,1,0.0
pabulum,1,0,0,-0.007751027598355844,1,0.0
95,1,0,3,0.015149735760422781,4,2.0
properties,1,0,0,-0.007751027598355844,1,0.0
dishonorable,0,0,1,0.007574867880211391,1,0.0
jock,1,0,0,-0.007751027598355844,1,0.0
sneakers,0,0,1,0.007574867880211391,1,0.0
underwritten,1,0,1,-0.0001174398120963021,2,1.0
valueless,1,0,0,-0.007751027598355844,1,0.0
promotion,2,0,0,-0.015443335290663537,2,1.0
models,1,0,1,-0.0001174398120963021,2,1.0
optimism,0,0,1,0.007574867880211391,1,0.0
lighter,2,0,0,-0.015443335290663537,2,1.0
teenaged,1,0,0,-0.007751027598355844,1,0.0
gangsta,0,0,1,0.007574867880211391,1,0.0
tones,0,0,1,0.007574867880211391,1,0.0
pint,0,0,1,0.007574867880211391,1,0.0
scriptwriters,0,0,1,0.007574867880211391,1,0.0
dispense,1,0,0,-0.007751027598355844,1,0.0
usher,1,0,0,-0.007751027598355844,1,0.0
copies,1,0,0,-0.007751027598355844,1,0.0
sua,1,0,0,-0.007751027598355844,1,0.0
incompetência,1,0,0,-0.007751027598355844,1,0.0
péssima,1,0,0,-0.007751027598355844,1,0.0
superada,1,0,0,-0.007751027598355844,1,0.0
roteirista,2,0,0,-0.015443335290663537,2,1.0
rosario,0,0,1,0.007574867880211391,1,0.0
undistinguished,3,0,0,-0.02313564298297123,3,1.5849625007211563
circular,1,0,0,-0.007751027598355844,1,0.0
mattei,4,0,2,-0.015560775102759838,6,2.584962500721156
needing,1,0,0,-0.007751027598355844,1,0.0
jungle,1,0,0,-0.007751027598355844,1,0.0
kane,1,0,0,-0.007751027598355844,1,0.0
lint,1,0,1,-0.0001174398120963021,2,1.0
accumulate,1,0,0,-0.007751027598355844,1,0.0
corruscating,1,0,0,-0.007751027598355844,1,0.0
carousel,1,0,0,-0.007751027598355844,1,0.0
tattered,1,0,0,-0.007751027598355844,1,0.0
behold,1,0,1,-0.0001174398120963021,2,1.0
infatuated,2,0,0,-0.015443335290663537,2,1.0
conveyor,1,0,0,-0.007751027598355844,1,0.0
underdeveloped,1,0,0,-0.007751027598355844,1,0.0
loveless,1,0,0,-0.007751027598355844,1,0.0
rethink,1,0,0,-0.007751027598355844,1,0.0
imprimatur,1,0,0,-0.007751027598355844,1,0.0
lend,1,0,0,-0.007751027598355844,1,0.0
redford,1,0,0,-0.007751027598355844,1,0.0
omnibus,0,0,1,0.007574867880211391,1,0.0
romances,1,0,1,-0.0001174398120963021,2,1.0
blip,2,0,0,-0.015443335290663537,2,1.0
registering,1,0,0,-0.007751027598355844,1,0.0
kazmierski,1,0,0,-0.007751027598355844,1,0.0
grungy,1,0,0,-0.007751027598355844,1,0.0
shabby,2,0,0,-0.015443335290663537,2,1.0
fosters,0,0,1,0.007574867880211391,1,0.0
basted,1,0,0,-0.007751027598355844,1,0.0
gravy,1,0,0,-0.007751027598355844,1,0.0
chip,1,0,0,-0.007751027598355844,1,0.0
leftover,2,0,0,-0.015443335290663537,2,1.0
microwaves,1,0,0,-0.007751027598355844,1,0.0
desultory,1,0,0,-0.007751027598355844,1,0.0
prevails,1,0,0,-0.007751027598355844,1,0.0
workshop,1,0,0,-0.007751027598355844,1,0.0
unifying,1,0,0,-0.007751027598355844,1,0.0
tenths,1,0,0,-0.007751027598355844,1,0.0
hollow,3,0,0,-0.02313564298297123,3,1.5849625007211563
percolates,1,0,0,-0.007751027598355844,1,0.0
evincing,1,0,0,-0.007751027598355844,1,0.0
aesthetics,1,0,0,-0.007751027598355844,1,0.0
whine,3,0,0,-0.02313564298297123,3,1.5849625007211563
profundity,1,0,2,0.0075161479741632405,3,1.5849625007211563
indicated,1,0,0,-0.007751027598355844,1,0.0
circularity,1,0,0,-0.007751027598355844,1,0.0
skeleton,0,0,1,0.007574867880211391,1,0.0
radiance,0,0,1,0.007574867880211391,1,0.0
picking,0,0,1,0.007574867880211391,1,0.0
embody,0,0,2,0.015208455666470933,2,1.0
credibility,0,0,1,0.007574867880211391,1,0.0
carente,1,0,0,-0.007751027598355844,1,0.0
dirigida,1,0,0,-0.007751027598355844,1,0.0
mal,1,0,0,-0.007751027598355844,1,0.0
pérdida,1,0,0,-0.007751027598355844,1,0.0
ápice,1,0,0,-0.007751027598355844,1,0.0
dinero,1,0,0,-0.007751027598355844,1,0.0
imaginación,1,0,0,-0.007751027598355844,1,0.0
verdadera,1,0,0,-0.007751027598355844,1,0.0
peor,1,0,0,-0.007751027598355844,1,0.0
workmanlike,1,0,1,-0.0001174398120963021,2,1.0
plus,1,0,3,0.015149735760422781,4,2.0
palpable,1,0,1,-0.0001174398120963021,2,1.0
fortified,1,0,0,-0.007751027598355844,1,0.0
unforgivably,1,0,0,-0.007751027598355844,1,0.0
macy,1,0,0,-0.007751027598355844,1,0.0
balloon,1,0,0,-0.007751027598355844,1,0.0
punish,1,0,0,-0.007751027598355844,1,0.0
munchausen,1,0,0,-0.007751027598355844,1,0.0
suffocated,2,0,0,-0.015443335290663537,2,1.0
mum,1,0,0,-0.007751027598355844,1,0.0
adore,1,0,0,-0.007751027598355844,1,0.0
proxy,1,0,0,-0.007751027598355844,1,0.0
ditches,0,0,1,0.007574867880211391,1,0.0
odious,0,0,1,0.007574867880211391,1,0.0
prostitution,0,0,1,0.007574867880211391,1,0.0
pc,0,0,1,0.007574867880211391,1,0.0
cinderella,0,0,2,0.015208455666470933,2,1.0
norma,1,0,0,-0.007751027598355844,1,0.0
rae,1,0,0,-0.007751027598355844,1,0.0
montages,0,0,1,0.007574867880211391,1,0.0
slipper,0,0,2,0.015208455666470933,2,1.0
shrewdly,0,0,1,0.007574867880211391,1,0.0
surrounds,0,0,1,0.007574867880211391,1,0.0
diva,0,0,1,0.007574867880211391,1,0.0
jennifer,3,0,1,-0.015502055196711688,4,2.0
cynics,0,0,1,0.007574867880211391,1,0.0
judgment,1,0,1,-0.0001174398120963021,2,1.0
airless,1,0,0,-0.007751027598355844,1,0.0
prepackaged,1,0,0,-0.007751027598355844,1,0.0
stinks,3,0,0,-0.02313564298297123,3,1.5849625007211563
publicist,1,0,0,-0.007751027598355844,1,0.0
mongering,1,0,0,-0.007751027598355844,1,0.0
wannabe,3,0,0,-0.02313564298297123,3,1.5849625007211563
blueprint,1,0,0,-0.007751027598355844,1,0.0
bidder,1,0,0,-0.007751027598355844,1,0.0
sleeve,0,0,2,0.015208455666470933,2,1.0
plotline,0,0,1,0.007574867880211391,1,0.0
lameness,1,0,0,-0.007751027598355844,1,0.0
schlock,2,0,0,-0.015443335290663537,2,1.0
unoriginality,1,0,0,-0.007751027598355844,1,0.0
predictability,1,0,1,-0.0001174398120963021,2,1.0
writhing,1,0,0,-0.007751027598355844,1,0.0
wang,1,0,0,-0.007751027598355844,1,0.0
graduated,1,0,0,-0.007751027598355844,1,0.0
blandly,2,0,0,-0.015443335290663537,2,1.0
elementary,1,0,0,-0.007751027598355844,1,0.0
lofty,0,0,2,0.015208455666470933,2,1.0
inspection,0,0,1,0.007574867880211391,1,0.0
confection,0,0,2,0.015208455666470933,2,1.0
lovably,0,0,1,0.007574867880211391,1,0.0
aftertaste,1,0,0,-0.007751027598355844,1,0.0
offend,1,0,1,-0.0001174398120963021,2,1.0
concepts,1,0,0,-0.007751027598355844,1,0.0
sheets,1,0,0,-0.007751027598355844,1,0.0
dreaming,1,0,0,-0.007751027598355844,1,0.0
inspector,1,0,0,-0.007751027598355844,1,0.0
iraqi,1,0,0,-0.007751027598355844,1,0.0
raunchy,3,0,3,-0.0002348796241926042,6,2.584962500721156
flops,0,0,1,0.007574867880211391,1,0.0
runteldat,2,0,2,-0.00017615971814445228,4,2.0
obscenity,1,0,0,-0.007751027598355844,1,0.0
quashed,1,0,0,-0.007751027598355844,1,0.0
tirade,1,0,0,-0.007751027598355844,1,0.0
glorified,3,0,0,-0.02313564298297123,3,1.5849625007211563
lovefest,1,0,0,-0.007751027598355844,1,0.0
outwardly,1,0,0,-0.007751027598355844,1,0.0
presentation,2,0,1,-0.007809747504403995,3,1.5849625007211563
liability,2,0,0,-0.015443335290663537,2,1.0
observer,1,0,0,-0.007751027598355844,1,0.0
evaluate,1,0,0,-0.007751027598355844,1,0.0
hates,2,0,0,-0.015443335290663537,2,1.0
bluer,0,0,1,0.007574867880211391,1,0.0
biologically,0,0,1,0.007574867880211391,1,0.0
indignation,0,0,1,0.007574867880211391,1,0.0
susceptible,0,0,1,0.007574867880211391,1,0.0
marrrr,1,0,0,-0.007751027598355844,1,0.0
bellyaching,1,0,0,-0.007751027598355844,1,0.0
tragedies,1,0,1,-0.0001174398120963021,2,1.0
proven,1,0,1,-0.0001174398120963021,2,1.0
onion,1,0,0,-0.007751027598355844,1,0.0
letterman,1,0,0,-0.007751027598355844,1,0.0
fertile,1,0,0,-0.007751027598355844,1,0.0
fewer,2,0,0,-0.015443335290663537,2,1.0
pryor,3,0,0,-0.02313564298297123,3,1.5849625007211563
pitying,1,0,0,-0.007751027598355844,1,0.0
palaver,1,0,0,-0.007751027598355844,1,0.0
pandering,3,0,1,-0.015502055196711688,4,2.0
filthy,0,0,1,0.007574867880211391,1,0.0
volcano,1,0,0,-0.007751027598355844,1,0.0
septic,1,0,0,-0.007751027598355844,1,0.0
er,1,0,1,-0.0001174398120963021,2,1.0
overflowing,1,0,0,-0.007751027598355844,1,0.0
misogyny,2,0,0,-0.015443335290663537,2,1.0
unleashes,1,0,0,-0.007751027598355844,1,0.0
unimaginatively,1,0,0,-0.007751027598355844,1,0.0
dulling,0,0,1,0.007574867880211391,1,0.0
wiser,0,0,1,0.007574867880211391,1,0.0
periods,0,0,1,0.007574867880211391,1,0.0
mopping,0,0,1,0.007574867880211391,1,0.0
preaches,1,0,0,-0.007751027598355844,1,0.0
illness,0,0,1,0.007574867880211391,1,0.0
childbirth,0,0,1,0.007574867880211391,1,0.0
feeding,0,0,1,0.007574867880211391,1,0.0
recovering,1,0,1,-0.0001174398120963021,2,1.0
breast,1,0,1,-0.0001174398120963021,2,1.0
depict,0,0,1,0.007574867880211391,1,0.0
deploy,0,0,1,0.007574867880211391,1,0.0
horrors,2,0,0,-0.015443335290663537,2,1.0
plumbs,0,0,1,0.007574867880211391,1,0.0
topical,2,0,1,-0.007809747504403995,3,1.5849625007211563
probation,1,0,0,-0.007751027598355844,1,0.0
remarks,1,0,0,-0.007751027598355844,1,0.0
geared,1,0,0,-0.007751027598355844,1,0.0
spalding,1,0,0,-0.007751027598355844,1,0.0
mibii,0,0,1,0.007574867880211391,1,0.0
extravagantly,0,0,1,0.007574867880211391,1,0.0
recreated,0,0,2,0.015208455666470933,2,1.0
taciturn,0,0,1,0.007574867880211391,1,0.0
strain,0,0,2,0.015208455666470933,2,1.0
sillier,0,0,1,0.007574867880211391,1,0.0
cuter,0,0,1,0.007574867880211391,1,0.0
unadulterated,0,0,1,0.007574867880211391,1,0.0
concession,1,0,1,-0.0001174398120963021,2,1.0
restroom,1,0,0,-0.007751027598355844,1,0.0
itis,1,0,0,-0.007751027598355844,1,0.0
earmarks,1,0,0,-0.007751027598355844,1,0.0
lukewarm,2,0,0,-0.015443335290663537,2,1.0
trotting,1,0,0,-0.007751027598355844,1,0.0
demand,1,0,0,-0.007751027598355844,1,0.0
noticeably,1,0,0,-0.007751027598355844,1,0.0
predecesora,0,0,1,0.007574867880211391,1,0.0
demencial,0,0,1,0.007574867880211391,1,0.0
ejemplo,0,0,1,0.007574867880211391,1,0.0
buen,0,0,1,0.007574867880211391,1,0.0
entretenimiento,0,0,1,0.007574867880211391,1,0.0
cine,0,0,1,0.007574867880211391,1,0.0
complejos,0,0,1,0.007574867880211391,1,0.0
puro,0,0,1,0.007574867880211391,1,0.0
sarcástica,0,0,1,0.007574867880211391,1,0.0
levity,1,0,1,-0.0001174398120963021,2,1.0
rapid,0,0,1,0.007574867880211391,1,0.0
dismissed,1,0,2,0.0075161479741632405,3,1.5849625007211563
funniness,1,0,0,-0.007751027598355844,1,0.0
outward,1,0,0,-0.007751027598355844,1,0.0
flakiness,1,0,0,-0.007751027598355844,1,0.0
bust,2,0,0,-0.015443335290663537,2,1.0
scattered,6,0,1,-0.03857897827363477,7,2.807354922057604
sameness,1,0,0,-0.007751027598355844,1,0.0
camouflage,1,0,0,-0.007751027598355844,1,0.0
repeats,1,0,0,-0.007751027598355844,1,0.0
reel,2,0,0,-0.015443335290663537,2,1.0
86,2,0,1,-0.007809747504403995,3,1.5849625007211563
hating,1,0,0,-0.007751027598355844,1,0.0
owes,1,0,1,-0.0001174398120963021,2,1.0
pug,2,0,0,-0.015443335290663537,2,1.0
notwithstanding,1,0,2,0.0075161479741632405,3,1.5849625007211563
tempting,1,0,1,-0.0001174398120963021,2,1.0
milder,1,0,0,-0.007751027598355844,1,0.0
recycles,2,0,0,-0.015443335290663537,2,1.0
insignificance,1,0,0,-0.007751027598355844,1,0.0
whiffle,1,0,0,-0.007751027598355844,1,0.0
cornball,0,0,1,0.007574867880211391,1,0.0
naturedly,0,0,1,0.007574867880211391,1,0.0
rubbery,0,0,1,0.007574867880211391,1,0.0
retain,0,0,1,0.007574867880211391,1,0.0
zip,1,0,0,-0.007751027598355844,1,0.0
motions,3,0,0,-0.02313564298297123,3,1.5849625007211563
pocket,0,0,1,0.007574867880211391,1,0.0
jingles,0,0,1,0.007574867880211391,1,0.0
forsaken,1,0,0,-0.007751027598355844,1,0.0
centre,1,0,0,-0.007751027598355844,1,0.0
pushed,1,0,0,-0.007751027598355844,1,0.0
astounds,0,0,1,0.007574867880211391,1,0.0
dazzles,0,0,1,0.007574867880211391,1,0.0
bags,1,0,1,-0.0001174398120963021,2,1.0
awards,0,0,2,0.015208455666470933,2,1.0
indicates,1,0,0,-0.007751027598355844,1,0.0
astonishingframes,0,0,1,0.007574867880211391,1,0.0
inquiry,0,0,1,0.007574867880211391,1,0.0
bladerunner,0,0,1,0.007574867880211391,1,0.0
subtler,1,0,1,-0.0001174398120963021,2,1.0
dense,0,0,1,0.007574867880211391,1,0.0
kickass,0,0,1,0.007574867880211391,1,0.0
intensifying,0,0,1,0.007574867880211391,1,0.0
mawkishness,0,0,1,0.007574867880211391,1,0.0
gawk,0,0,1,0.007574867880211391,1,0.0
wallpaper,0,0,1,0.007574867880211391,1,0.0
spielbergian,0,0,1,0.007574867880211391,1,0.0
desiccated,1,0,0,-0.007751027598355844,1,0.0
antiseptic,1,0,0,-0.007751027598355844,1,0.0
althoughvisually,1,0,0,-0.007751027598355844,1,0.0
viewings,0,0,1,0.007574867880211391,1,0.0
invites,0,0,2,0.015208455666470933,2,1.0
diminish,0,0,1,0.007574867880211391,1,0.0
quibble,0,0,1,0.007574867880211391,1,0.0
144,0,0,1,0.007574867880211391,1,0.0
quibbling,0,0,1,0.007574867880211391,1,0.0
accommodates,0,0,1,0.007574867880211391,1,0.0
exhilaration,0,0,1,0.007574867880211391,1,0.0
digested,0,0,1,0.007574867880211391,1,0.0
minimally,1,0,0,-0.007751027598355844,1,0.0
auspicious,0,0,1,0.007574867880211391,1,0.0
unnerve,0,0,1,0.007574867880211391,1,0.0
pushes,0,0,2,0.015208455666470933,2,1.0
liable,0,0,1,0.007574867880211391,1,0.0
notes,1,0,1,-0.0001174398120963021,2,1.0
brazil,0,0,1,0.007574867880211391,1,0.0
sole,1,0,0,-0.007751027598355844,1,0.0
intelligently,0,0,1,0.007574867880211391,1,0.0
potato,1,0,1,-0.0001174398120963021,2,1.0
nervous,1,0,0,-0.007751027598355844,1,0.0
silberling,2,0,0,-0.015443335290663537,2,1.0
lighten,1,0,0,-0.007751027598355844,1,0.0
pompeo,0,0,2,0.015208455666470933,2,1.0
holly,0,0,1,0.007574867880211391,1,0.0
dustin,0,0,1,0.007574867880211391,1,0.0
gyllenhaal,1,0,6,0.03805049911920141,7,2.807354922057604
rising,1,0,2,0.0075161479741632405,3,1.5849625007211563
winners,1,0,1,-0.0001174398120963021,2,1.0
hoffman,0,0,1,0.007574867880211391,1,0.0
aplomb,0,0,1,0.007574867880211391,1,0.0
ellen,0,0,2,0.015208455666470933,2,1.0
managing,0,0,1,0.007574867880211391,1,0.0
mornings,0,0,1,0.007574867880211391,1,0.0
moonlight,2,0,10,0.060892542571931885,12,3.5849625007211565
attempting,0,0,1,0.007574867880211391,1,0.0
zeitgeist,0,0,1,0.007574867880211391,1,0.0
covered,1,0,0,-0.007751027598355844,1,0.0
unbelievably,0,0,2,0.015208455666470933,2,1.0
spates,0,0,1,0.007574867880211391,1,0.0
mawkish,0,0,1,0.007574867880211391,1,0.0
limbo,1,0,1,-0.0001174398120963021,2,1.0
liberation,0,0,1,0.007574867880211391,1,0.0
outreach,0,0,1,0.007574867880211391,1,0.0
eradicable,0,0,1,0.007574867880211391,1,0.0
bedroom,0,0,1,0.007574867880211391,1,0.0
defanged,0,0,1,0.007574867880211391,1,0.0
gimmickry,0,0,1,0.007574867880211391,1,0.0
survivors,1,0,0,-0.007751027598355844,1,0.0
demonstrations,0,0,1,0.007574867880211391,1,0.0
resilience,0,0,1,0.007574867880211391,1,0.0
acclaimed,1,0,0,-0.007751027598355844,1,0.0
potentially,3,0,2,-0.007868467410452145,5,2.321928094887362
actresses,1,0,4,0.022783323546682326,5,2.321928094887362
chords,0,0,1,0.007574867880211391,1,0.0
analytical,0,0,1,0.007574867880211391,1,0.0
permits,0,0,2,0.015208455666470933,2,1.0
illogic,1,0,1,-0.0001174398120963021,2,1.0
contradictory,1,0,1,-0.0001174398120963021,2,1.0
awfully,1,0,1,-0.0001174398120963021,2,1.0
achingly,0,0,3,0.022842043452730474,3,1.5849625007211563
hug,1,0,0,-0.007751027598355844,1,0.0
wryness,0,0,1,0.007574867880211391,1,0.0
remorse,0,0,1,0.007574867880211391,1,0.0
unaccountable,0,0,1,0.007574867880211391,1,0.0
irredeemable,0,0,1,0.007574867880211391,1,0.0
embracing,0,0,3,0.022842043452730474,3,1.5849625007211563
restraint,1,0,0,-0.007751027598355844,1,0.0
anarchic,1,0,0,-0.007751027598355844,1,0.0
gilmore,1,0,1,-0.0001174398120963021,2,1.0
waterboy,2,0,0,-0.015443335290663537,2,1.0
formuliac,0,0,1,0.007574867880211391,1,0.0
nicky,0,0,1,0.007574867880211391,1,0.0
assault,1,0,0,-0.007751027598355844,1,0.0
ryder,1,0,0,-0.007751027598355844,1,0.0
puzzling,2,0,0,-0.015443335290663537,2,1.0
capra,3,0,0,-0.02313564298297123,3,1.5849625007211563
graves,1,0,0,-0.007751027598355844,1,0.0
reappearing,0,0,1,0.007574867880211391,1,0.0
turturro,1,0,1,-0.0001174398120963021,2,1.0
butler,1,0,1,-0.0001174398120963021,2,1.0
sneaky,0,0,1,0.007574867880211391,1,0.0
disappearing,0,0,1,0.007574867880211391,1,0.0
pillages,1,0,0,-0.007751027598355844,1,0.0
incinerates,1,0,0,-0.007751027598355844,1,0.0
rapes,1,0,0,-0.007751027598355844,1,0.0
tissue,2,0,0,-0.015443335290663537,2,1.0
spanish,1,0,0,-0.007751027598355844,1,0.0
fetish,1,0,0,-0.007751027598355844,1,0.0
racehorse,1,0,0,-0.007751027598355844,1,0.0
gnat,1,0,0,-0.007751027598355844,1,0.0
primer,1,0,0,-0.007751027598355844,1,0.0
rejoice,0,0,1,0.007574867880211391,1,0.0
wedding,1,0,9,0.06095126247798004,10,3.3219280948873626
suitable,0,0,1,0.007574867880211391,1,0.0
requiring,0,0,1,0.007574867880211391,1,0.0
attached,0,0,1,0.007574867880211391,1,0.0
celebrities,0,0,1,0.007574867880211391,1,0.0
naturedness,0,0,1,0.007574867880211391,1,0.0
goofiness,0,0,1,0.007574867880211391,1,0.0
consumer,1,0,0,-0.007751027598355844,1,0.0
outweigh,1,0,0,-0.007751027598355844,1,0.0
positives,1,0,0,-0.007751027598355844,1,0.0
negatives,1,0,0,-0.007751027598355844,1,0.0
surfacing,1,0,0,-0.007751027598355844,1,0.0
iq,2,0,0,-0.015443335290663537,2,1.0
25,2,0,0,-0.015443335290663537,2,1.0
license,1,0,0,-0.007751027598355844,1,0.0
inappropriate,2,0,0,-0.015443335290663537,2,1.0
fishing,1,0,0,-0.007751027598355844,1,0.0
repeating,1,0,0,-0.007751027598355844,1,0.0
produces,1,0,0,-0.007751027598355844,1,0.0
vehicles,1,0,0,-0.007751027598355844,1,0.0
dimwitted,1,0,0,-0.007751027598355844,1,0.0
dimmer,1,0,0,-0.007751027598355844,1,0.0
decorative,0,0,1,0.007574867880211391,1,0.0
relegating,0,0,1,0.007574867880211391,1,0.0
hazy,1,0,0,-0.007751027598355844,1,0.0
mccrudden,1,0,0,-0.007751027598355844,1,0.0
italicized,1,0,0,-0.007751027598355844,1,0.0
hustling,1,0,0,-0.007751027598355844,1,0.0
hounds,1,0,0,-0.007751027598355844,1,0.0
robotically,1,0,0,-0.007751027598355844,1,0.0
tract,2,0,0,-0.015443335290663537,2,1.0
kicks,2,0,0,-0.015443335290663537,2,1.0
whimper,1,0,0,-0.007751027598355844,1,0.0
inauspicious,1,0,0,-0.007751027598355844,1,0.0
pretends,1,0,1,-0.0001174398120963021,2,1.0
hustlers,1,0,0,-0.007751027598355844,1,0.0
exploitive,2,0,0,-0.015443335290663537,2,1.0
faultlessly,1,0,0,-0.007751027598355844,1,0.0
altogether,1,0,2,0.0075161479741632405,3,1.5849625007211563
baggage,1,0,0,-0.007751027598355844,1,0.0
downplaying,1,0,0,-0.007751027598355844,1,0.0
derails,1,0,0,-0.007751027598355844,1,0.0
fits,2,0,3,0.0074574280681150885,5,2.321928094887362
web,0,0,2,0.015208455666470933,2,1.0
uncompromisingly,0,0,1,0.007574867880211391,1,0.0
corners,0,0,3,0.022842043452730474,3,1.5849625007211563
lift,1,0,0,-0.007751027598355844,1,0.0
mouserabove,1,0,0,-0.007751027598355844,1,0.0
avenges,1,0,0,-0.007751027598355844,1,0.0
pathologically,1,0,0,-0.007751027598355844,1,0.0
purported,1,0,0,-0.007751027598355844,1,0.0
hatred,1,0,0,-0.007751027598355844,1,0.0
succeeded,1,0,1,-0.0001174398120963021,2,1.0
groggy,1,0,0,-0.007751027598355844,1,0.0
spat,1,0,0,-0.007751027598355844,1,0.0
assembly,1,0,1,-0.0001174398120963021,2,1.0
tinseltown,2,0,0,-0.015443335290663537,2,1.0
implies,1,0,2,0.0075161479741632405,3,1.5849625007211563
flaw,1,0,0,-0.007751027598355844,1,0.0
gel,2,0,0,-0.015443335290663537,2,1.0
plateau,0,0,1,0.007574867880211391,1,0.0
interrogation,0,0,1,0.007574867880211391,1,0.0
uncertain,2,0,1,-0.007809747504403995,3,1.5849625007211563
likability,0,0,1,0.007574867880211391,1,0.0
assets,0,0,1,0.007574867880211391,1,0.0
strongest,0,0,1,0.007574867880211391,1,0.0
noteworthy,0,0,1,0.007574867880211391,1,0.0
widget,0,0,1,0.007574867880211391,1,0.0
gayton,1,0,0,-0.007751027598355844,1,0.0
telegraphs,1,0,0,-0.007751027598355844,1,0.0
convenience,1,0,0,-0.007751027598355844,1,0.0
gay,1,0,1,-0.0001174398120963021,2,1.0
liking,1,0,0,-0.007751027598355844,1,0.0
behaviour,1,0,0,-0.007751027598355844,1,0.0
grounding,1,0,1,-0.0001174398120963021,2,1.0
latently,1,0,0,-0.007751027598355844,1,0.0
baboon,1,0,0,-0.007751027598355844,1,0.0
misleading,1,0,0,-0.007751027598355844,1,0.0
resent,0,0,1,0.007574867880211391,1,0.0
souls,0,0,2,0.015208455666470933,2,1.0
wheels,0,0,1,0.007574867880211391,1,0.0
mouth,1,0,2,0.0075161479741632405,3,1.5849625007211563
tackling,0,0,1,0.007574867880211391,1,0.0
dished,0,0,1,0.007574867880211391,1,0.0
lovingly,0,0,2,0.015208455666470933,2,1.0
eats,0,0,2,0.015208455666470933,2,1.0
argues,0,0,1,0.007574867880211391,1,0.0
meddles,0,0,1,0.007574867880211391,1,0.0
kibbitzes,0,0,1,0.007574867880211391,1,0.0
greeks,0,0,2,0.015208455666470933,2,1.0
invented,1,0,1,-0.0001174398120963021,2,1.0
souvlaki,1,0,0,-0.007751027598355844,1,0.0
indigestion,1,0,0,-0.007751027598355844,1,0.0
bliss,0,0,1,0.007574867880211391,1,0.0
lay,0,0,2,0.015208455666470933,2,1.0
mediterranean,1,0,1,-0.0001174398120963021,2,1.0
fondness,0,0,1,0.007574867880211391,1,0.0
addams,0,0,1,0.007574867880211391,1,0.0
quandaries,0,0,1,0.007574867880211391,1,0.0
whirlwind,0,0,1,0.007574867880211391,1,0.0
ouzo,0,0,1,0.007574867880211391,1,0.0
ethnic,3,0,1,-0.015502055196711688,4,2.0
regrets,1,0,0,-0.007751027598355844,1,0.0
sitcomyou,1,0,0,-0.007751027598355844,1,0.0
animal,3,0,1,-0.015502055196711688,4,2.0
boundaries,0,0,1,0.007574867880211391,1,0.0
gyro,0,0,1,0.007574867880211391,1,0.0
pronounce,0,0,2,0.015208455666470933,2,1.0
vardalos,0,0,3,0.022842043452730474,3,1.5849625007211563
en,1,0,4,0.022783323546682326,5,2.321928094887362
menos,0,0,1,0.007574867880211391,1,0.0
moderadamente,0,0,1,0.007574867880211391,1,0.0
pitas,0,0,1,0.007574867880211391,1,0.0
pizzas,0,0,1,0.007574867880211391,1,0.0
gana,0,0,1,0.007574867880211391,1,0.0
verla,0,0,1,0.007574867880211391,1,0.0
quizá,0,0,1,0.007574867880211391,1,0.0
actorsbring,0,0,1,0.007574867880211391,1,0.0
simplicity,1,0,3,0.015149735760422781,4,2.0
warmhearted,0,0,2,0.015208455666470933,2,1.0
terribly,3,0,1,-0.015502055196711688,4,2.0
messy,2,0,1,-0.007809747504403995,3,1.5849625007211563
calories,0,0,1,0.007574867880211391,1,0.0
corbett,0,0,1,0.007574867880211391,1,0.0
zwick,1,0,1,-0.0001174398120963021,2,1.0
blockbusters,1,0,1,-0.0001174398120963021,2,1.0
pollute,1,0,0,-0.007751027598355844,1,0.0
sluggishly,1,0,0,-0.007751027598355844,1,0.0
crackle,2,0,0,-0.015443335290663537,2,1.0
overbearing,1,0,0,-0.007751027598355844,1,0.0
depicts,1,0,0,-0.007751027598355844,1,0.0
comparative,0,0,1,0.007574867880211391,1,0.0
accuracy,0,0,1,0.007574867880211391,1,0.0
testify,0,0,1,0.007574867880211391,1,0.0
monsoon,0,0,1,0.007574867880211391,1,0.0
anachronistic,0,0,1,0.007574867880211391,1,0.0
lusty,0,0,1,0.007574867880211391,1,0.0
resort,0,0,1,0.007574867880211391,1,0.0
99,0,0,1,0.007574867880211391,1,0.0
evans,0,0,1,0.007574867880211391,1,0.0
eternal,1,0,0,-0.007751027598355844,1,0.0
indifference,1,0,0,-0.007751027598355844,1,0.0
pique,1,0,0,-0.007751027598355844,1,0.0
amateurishness,1,0,0,-0.007751027598355844,1,0.0
7,3,0,0,-0.02313564298297123,3,1.5849625007211563
contenders,2,0,1,-0.007809747504403995,3,1.5849625007211563
marries,1,0,0,-0.007751027598355844,1,0.0
overexposed,1,0,1,-0.0001174398120963021,2,1.0
redolent,0,0,1,0.007574867880211391,1,0.0
uniquely,0,0,1,0.007574867880211391,1,0.0
glibly,1,0,0,-0.007751027598355844,1,0.0
sendo,1,0,0,-0.007751027598355844,1,0.0
tempo,1,0,0,-0.007751027598355844,1,0.0
estranhos,1,0,0,-0.007751027598355844,1,0.0
bom,1,0,0,-0.007751027598355844,1,0.0
andamento,1,0,0,-0.007751027598355844,1,0.0
depois,1,0,0,-0.007751027598355844,1,0.0
explicados,1,0,0,-0.007751027598355844,1,0.0
ótimo,1,0,0,-0.007751027598355844,1,0.0
instante,1,0,0,-0.007751027598355844,1,0.0
pelo,2,0,0,-0.015443335290663537,2,1.0
partir,1,0,1,-0.0001174398120963021,2,1.0
frustrado,1,0,0,-0.007751027598355844,1,0.0
perde,1,0,0,-0.007751027598355844,1,0.0
acontecimentos,1,0,0,-0.007751027598355844,1,0.0
roteiro,1,0,0,-0.007751027598355844,1,0.0
esforço,1,0,0,-0.007751027598355844,1,0.0
trama,1,0,0,-0.007751027598355844,1,0.0
levar,1,0,0,-0.007751027598355844,1,0.0
colocar,1,0,0,-0.007751027598355844,1,0.0
relevancy,1,0,0,-0.007751027598355844,1,0.0
crummy,1,0,0,-0.007751027598355844,1,0.0
labelled,1,0,0,-0.007751027598355844,1,0.0
realistic,1,0,3,0.015149735760422781,4,2.0
unholy,1,0,0,-0.007751027598355844,1,0.0
1988,0,0,1,0.007574867880211391,1,0.0
koyaanisqatsi,0,0,1,0.007574867880211391,1,0.0
collage,1,0,2,0.0075161479741632405,3,1.5849625007211563
powaqqatsi,0,0,1,0.007574867880211391,1,0.0
naqoyqatsi,1,0,2,0.0075161479741632405,3,1.5849625007211563
1983,0,0,1,0.007574867880211391,1,0.0
virtuosity,2,0,0,-0.015443335290663537,2,1.0
squeezed,0,0,2,0.015208455666470933,2,1.0
reggio,4,0,6,0.014973576042278329,10,3.3219280948873626
commercialism,0,0,2,0.015208455666470933,2,1.0
godfrey,0,0,2,0.015208455666470933,2,1.0
detriment,2,0,0,-0.015443335290663537,2,1.0
polemical,2,0,0,-0.015443335290663537,2,1.0
continual,0,0,1,0.007574867880211391,1,0.0
curtains,0,0,1,0.007574867880211391,1,0.0
essay,0,0,1,0.007574867880211391,1,0.0
cd,1,0,0,-0.007751027598355844,1,0.0
intoxicating,0,0,1,0.007574867880211391,1,0.0
qatsi,1,0,1,-0.0001174398120963021,2,1.0
siblings,1,0,1,-0.0001174398120963021,2,1.0
truths,0,0,1,0.007574867880211391,1,0.0
spellbinding,0,0,1,0.007574867880211391,1,0.0
grain,0,0,1,0.007574867880211391,1,0.0
entrancing,0,0,1,0.007574867880211391,1,0.0
extensive,2,0,1,-0.007809747504403995,3,1.5849625007211563
jagged,1,0,0,-0.007751027598355844,1,0.0
monitor,1,0,0,-0.007751027598355844,1,0.0
directly,1,0,0,-0.007751027598355844,1,0.0
scorns,1,0,0,-0.007751027598355844,1,0.0
divining,0,0,1,0.007574867880211391,1,0.0
saturation,0,0,1,0.007574867880211391,1,0.0
composition,0,0,1,0.007574867880211391,1,0.0
opted,1,0,0,-0.007751027598355844,1,0.0
anew,0,0,1,0.007574867880211391,1,0.0
reigns,1,0,0,-0.007751027598355844,1,0.0
psychedelic,0,0,2,0.015208455666470933,2,1.0
theory,0,0,1,0.007574867880211391,1,0.0
tyco,1,0,0,-0.007751027598355844,1,0.0
ad,3,0,0,-0.02313564298297123,3,1.5849625007211563
ma,0,0,1,0.007574867880211391,1,0.0
prevalence,1,0,0,-0.007751027598355844,1,0.0
stringently,1,0,0,-0.007751027598355844,1,0.0
startle,1,0,0,-0.007751027598355844,1,0.0
stifled,1,0,0,-0.007751027598355844,1,0.0
forward,2,0,2,-0.00017615971814445228,4,2.0
trippy,1,0,1,-0.0001174398120963021,2,1.0
nike,2,0,0,-0.015443335290663537,2,1.0
purest,0,0,2,0.015208455666470933,2,1.0
repetition,1,0,0,-0.007751027598355844,1,0.0
baring,1,0,0,-0.007751027598355844,1,0.0
lullaby,1,0,0,-0.007751027598355844,1,0.0
dirgelike,1,0,0,-0.007751027598355844,1,0.0
fang,1,0,0,-0.007751027598355844,1,0.0
languorous,1,0,0,-0.007751027598355844,1,0.0
rhapsodize,1,0,0,-0.007751027598355844,1,0.0
frighteningly,0,0,2,0.015208455666470933,2,1.0
composed,3,0,1,-0.015502055196711688,4,2.0
prewarned,1,0,0,-0.007751027598355844,1,0.0
amaze,0,0,2,0.015208455666470933,2,1.0
wire,0,0,1,0.007574867880211391,1,0.0
eyebrows,1,0,0,-0.007751027598355844,1,0.0
liotta,1,0,3,0.015149735760422781,4,2.0
pounds,0,0,1,0.007574867880211391,1,0.0
tops,0,0,1,0.007574867880211391,1,0.0
prizes,0,0,1,0.007574867880211391,1,0.0
fooled,0,0,1,0.007574867880211391,1,0.0
patric,0,0,2,0.015208455666470933,2,1.0
hades,0,0,1,0.007574867880211391,1,0.0
medium,1,0,2,0.0075161479741632405,3,1.5849625007211563
amazingly,1,0,2,0.0075161479741632405,3,1.5849625007211563
renegade,0,0,1,0.007574867880211391,1,0.0
manual,0,0,1,0.007574867880211391,1,0.0
carnahan,1,0,1,-0.0001174398120963021,2,1.0
lapses,0,0,1,0.007574867880211391,1,0.0
grimy,0,0,2,0.015208455666470933,2,1.0
unanswered,0,0,1,0.007574867880211391,1,0.0
resolved,0,0,1,0.007574867880211391,1,0.0
pyrotechnics,1,0,0,-0.007751027598355844,1,0.0
outpaces,0,0,1,0.007574867880211391,1,0.0
contemporaries,0,0,1,0.007574867880211391,1,0.0
beatings,0,0,1,0.007574867880211391,1,0.0
shootings,0,0,1,0.007574867880211391,1,0.0
buoy,0,0,1,0.007574867880211391,1,0.0
undo,1,0,0,-0.007751027598355844,1,0.0
badge,0,0,1,0.007574867880211391,1,0.0
zips,0,0,1,0.007574867880211391,1,0.0
heralds,0,0,1,0.007574867880211391,1,0.0
caffeine,0,0,1,0.007574867880211391,1,0.0
rubs,0,0,1,0.007574867880211391,1,0.0
doughnut,0,0,1,0.007574867880211391,1,0.0
routes,0,0,1,0.007574867880211391,1,0.0
copmovieland,0,0,1,0.007574867880211391,1,0.0
deflated,0,0,1,0.007574867880211391,1,0.0
foundation,1,0,0,-0.007751027598355844,1,0.0
tucked,0,0,2,0.015208455666470933,2,1.0
traps,1,0,1,-0.0001174398120963021,2,1.0
subgenre,0,0,1,0.007574867880211391,1,0.0
beats,0,0,1,0.007574867880211391,1,0.0
smutty,1,0,0,-0.007751027598355844,1,0.0
categorize,1,0,0,-0.007751027598355844,1,0.0
ambivalent,0,0,1,0.007574867880211391,1,0.0
seeds,0,0,2,0.015208455666470933,2,1.0
91,1,0,0,-0.007751027598355844,1,0.0
kirshner,2,0,0,-0.015443335290663537,2,1.0
unravels,1,0,0,-0.007751027598355844,1,0.0
respond,2,0,0,-0.015443335290663537,2,1.0
cared,1,0,0,-0.007751027598355844,1,0.0
grayish,1,0,0,-0.007751027598355844,1,0.0
clarke,1,0,0,-0.007751027598355844,1,0.0
array,1,0,0,-0.007751027598355844,1,0.0
relegated,1,0,0,-0.007751027598355844,1,0.0
crawl,1,0,0,-0.007751027598355844,1,0.0
appalling,2,0,1,-0.007809747504403995,3,1.5849625007211563
odoriferous,1,0,0,-0.007751027598355844,1,0.0
rotten,1,0,0,-0.007751027598355844,1,0.0
grating,3,0,1,-0.015502055196711688,4,2.0
slacker,1,0,0,-0.007751027598355844,1,0.0
flunks,1,0,0,-0.007751027598355844,1,0.0
laughably,3,0,0,-0.02313564298297123,3,1.5849625007211563
dipsticks,1,0,0,-0.007751027598355844,1,0.0
rashomon,1,0,0,-0.007751027598355844,1,0.0
wrecks,1,0,0,-0.007751027598355844,1,0.0
tawdry,3,0,0,-0.02313564298297123,3,1.5849625007211563
whoop,1,0,0,-0.007751027598355844,1,0.0
choppy,3,0,0,-0.02313564298297123,3,1.5849625007211563
masquerading,1,0,0,-0.007751027598355844,1,0.0
cliques,1,0,0,-0.007751027598355844,1,0.0
sexploitation,1,0,0,-0.007751027598355844,1,0.0
governs,1,0,0,-0.007751027598355844,1,0.0
ravishing,1,0,0,-0.007751027598355844,1,0.0
smear,1,0,0,-0.007751027598355844,1,0.0
lip,1,0,0,-0.007751027598355844,1,0.0
waif,1,0,0,-0.007751027598355844,1,0.0
mishmash,1,0,0,-0.007751027598355844,1,0.0
applying,1,0,0,-0.007751027598355844,1,0.0
showgirls,2,0,0,-0.015443335290663537,2,1.0
trashy,3,0,0,-0.02313564298297123,3,1.5849625007211563
sleaze,1,0,0,-0.007751027598355844,1,0.0
berserk,1,0,0,-0.007751027598355844,1,0.0
overheated,1,0,0,-0.007751027598355844,1,0.0
dudsville,1,0,0,-0.007751027598355844,1,0.0
omission,1,0,0,-0.007751027598355844,1,0.0
prurient,1,0,0,-0.007751027598355844,1,0.0
blondes,1,0,0,-0.007751027598355844,1,0.0
probing,1,0,0,-0.007751027598355844,1,0.0
oscars,0,0,1,0.007574867880211391,1,0.0
mansion,1,0,0,-0.007751027598355844,1,0.0
indefinitely,1,0,0,-0.007751027598355844,1,0.0
sealed,1,0,0,-0.007751027598355844,1,0.0
remote,2,0,0,-0.015443335290663537,2,1.0
3000,2,0,0,-0.015443335290663537,2,1.0
dickens,1,0,10,0.06858485026423958,11,3.4594316186372978
passages,0,0,1,0.007574867880211391,1,0.0
crafts,0,0,1,0.007574867880211391,1,0.0
mcgrath,0,0,7,0.05337639459776864,7,2.807354922057604
douglas,0,0,4,0.03047563123899002,4,2.0
desert,1,0,0,-0.007751027598355844,1,0.0
refreshed,0,0,1,0.007574867880211391,1,0.0
shallower,1,0,0,-0.007751027598355844,1,0.0
egregiously,1,0,0,-0.007751027598355844,1,0.0
trimmed,0,0,1,0.007574867880211391,1,0.0
cowering,1,0,1,-0.0001174398120963021,2,1.0
genteel,1,0,1,-0.0001174398120963021,2,1.0
confectiona,0,0,1,0.007574867880211391,1,0.0
cliff,1,0,0,-0.007751027598355844,1,0.0
liberating,0,0,1,0.007574867880211391,1,0.0
lighthearted,0,0,1,0.007574867880211391,1,0.0
impudent,0,0,1,0.007574867880211391,1,0.0
humankind,0,0,1,0.007574867880211391,1,0.0
snickers,0,0,1,0.007574867880211391,1,0.0
scrooge,1,0,1,-0.0001174398120963021,2,1.0
trimmings,0,0,1,0.007574867880211391,1,0.0
halfhearted,1,0,1,-0.0001174398120963021,2,1.0
8th,0,0,1,0.007574867880211391,1,0.0
delving,0,0,1,0.007574867880211391,1,0.0
homosexual,0,0,1,0.007574867880211391,1,0.0
pops,0,0,1,0.007574867880211391,1,0.0
lane,2,0,12,0.07615971814445097,14,3.8073549220576037
undertones,0,0,1,0.007574867880211391,1,0.0
nathan,0,0,3,0.022842043452730474,3,1.5849625007211563
enhancing,0,0,1,0.007574867880211391,1,0.0
morals,0,0,1,0.007574867880211391,1,0.0
revision,0,0,1,0.007574867880211391,1,0.0
repressed,0,0,2,0.015208455666470933,2,1.0
twinkling,0,0,1,0.007574867880211391,1,0.0
shifts,0,0,1,0.007574867880211391,1,0.0
highlights,0,0,1,0.007574867880211391,1,0.0
plummer,0,0,3,0.022842043452730474,3,1.5849625007211563
crummles,0,0,1,0.007574867880211391,1,0.0
manager,1,0,1,-0.0001174398120963021,2,1.0
pages,1,0,1,-0.0001174398120963021,2,1.0
cliffsnotes,2,0,0,-0.015443335290663537,2,1.0
underdone,1,0,0,-0.007751027598355844,1,0.0
fragment,1,0,0,-0.007751027598355844,1,0.0
paraphrase,1,0,0,-0.007751027598355844,1,0.0
truncated,0,0,1,0.007574867880211391,1,0.0
lovable,0,0,2,0.015208455666470933,2,1.0
contraption,1,0,0,-0.007751027598355844,1,0.0
toned,0,0,1,0.007574867880211391,1,0.0
plunge,0,0,1,0.007574867880211391,1,0.0
moods,0,0,2,0.015208455666470933,2,1.0
900,0,0,1,0.007574867880211391,1,0.0
elicits,0,0,1,0.007574867880211391,1,0.0
19th,0,0,1,0.007574867880211391,1,0.0
prose,1,0,1,-0.0001174398120963021,2,1.0
fleshed,1,0,1,-0.0001174398120963021,2,1.0
deceit,0,0,1,0.007574867880211391,1,0.0
meanness,0,0,1,0.007574867880211391,1,0.0
evergreen,0,0,1,0.007574867880211391,1,0.0
exuberant,0,0,1,0.007574867880211391,1,0.0
expresses,0,0,1,0.007574867880211391,1,0.0
openness,0,0,1,0.007574867880211391,1,0.0
evocation,0,0,1,0.007574867880211391,1,0.0
beguiling,0,0,1,0.007574867880211391,1,0.0
enriched,0,0,1,0.007574867880211391,1,0.0
antic,0,0,1,0.007574867880211391,1,0.0
imaginatively,0,0,1,0.007574867880211391,1,0.0
subtlest,0,0,1,0.007574867880211391,1,0.0
complexly,0,0,1,0.007574867880211391,1,0.0
800,1,0,1,-0.0001174398120963021,2,1.0
page,1,0,2,0.0075161479741632405,3,1.5849625007211563
caste,0,0,1,0.007574867880211391,1,0.0
spotlights,0,0,1,0.007574867880211391,1,0.0
romanek,1,0,5,0.030416911332941866,6,2.584962500721156
scariest,0,0,1,0.007574867880211391,1,0.0
freaking,1,0,0,-0.007751027598355844,1,0.0
immaculately,1,0,0,-0.007751027598355844,1,0.0
demeanor,1,0,0,-0.007751027598355844,1,0.0
departs,1,0,0,-0.007751027598355844,1,0.0
suppressed,0,0,1,0.007574867880211391,1,0.0
malevolence,0,0,1,0.007574867880211391,1,0.0
finely,0,0,2,0.015208455666470933,2,1.0
strangeness,1,0,1,-0.0001174398120963021,2,1.0
queasy,0,0,1,0.007574867880211391,1,0.0
infatuation,0,0,1,0.007574867880211391,1,0.0
tautreflecting,0,0,1,0.007574867880211391,1,0.0
instability,0,0,2,0.015208455666470933,2,1.0
skin,0,0,3,0.022842043452730474,3,1.5849625007211563
generalities,0,0,1,0.007574867880211391,1,0.0
ditched,0,0,1,0.007574867880211391,1,0.0
bicentennial,0,0,1,0.007574867880211391,1,0.0
conspicuously,1,0,0,-0.007751027598355844,1,0.0
vinegar,1,0,0,-0.007751027598355844,1,0.0
plundered,1,0,0,-0.007751027598355844,1,0.0
thorn,1,0,0,-0.007751027598355844,1,0.0
examples,0,0,1,0.007574867880211391,1,0.0
examined,0,0,1,0.007574867880211391,1,0.0
poderosa,0,0,1,0.007574867880211391,1,0.0
guión,0,0,1,0.007574867880211391,1,0.0
ciertos,0,0,1,0.007574867880211391,1,0.0
fallas,0,0,1,0.007574867880211391,1,0.0
perdona,0,0,1,0.007574867880211391,1,0.0
recurre,0,0,1,0.007574867880211391,1,0.0
aunque,0,0,1,0.007574867880211391,1,0.0
género,0,0,2,0.015208455666470933,2,1.0
alienation,0,0,2,0.015208455666470933,2,1.0
advent,0,0,1,0.007574867880211391,1,0.0
snapshot,0,0,2,0.015208455666470933,2,1.0
pathologies,0,0,1,0.007574867880211391,1,0.0
photographic,0,0,1,0.007574867880211391,1,0.0
illusions,0,0,1,0.007574867880211391,1,0.0
decidedly,2,0,1,-0.007809747504403995,3,1.5849625007211563
lagging,0,0,1,0.007574867880211391,1,0.0
unstable,0,0,1,0.007574867880211391,1,0.0
environments,0,0,1,0.007574867880211391,1,0.0
sanity,0,0,1,0.007574867880211391,1,0.0
popeye,0,0,1,0.007574867880211391,1,0.0
ourselves,1,0,2,0.0075161479741632405,3,1.5849625007211563
exposing,0,0,1,0.007574867880211391,1,0.0
excursion,1,0,1,-0.0001174398120963021,2,1.0
epicenter,0,0,1,0.007574867880211391,1,0.0
unrepentant,0,0,1,0.007574867880211391,1,0.0
flattering,1,0,0,-0.007751027598355844,1,0.0
resonances,1,0,0,-0.007751027598355844,1,0.0
willams,0,0,1,0.007574867880211391,1,0.0
difficulty,0,0,1,0.007574867880211391,1,0.0
accepting,1,0,1,-0.0001174398120963021,2,1.0
madmen,0,0,1,0.007574867880211391,1,0.0
smiling,0,0,2,0.015208455666470933,2,1.0
cleverness,2,0,2,-0.00017615971814445228,4,2.0
pristine,0,0,2,0.015208455666470933,2,1.0
distinctive,1,0,1,-0.0001174398120963021,2,1.0
developments,1,0,0,-0.007751027598355844,1,0.0
60,1,0,0,-0.007751027598355844,1,0.0
processed,1,0,0,-0.007751027598355844,1,0.0
cheapen,1,0,0,-0.007751027598355844,1,0.0
eternally,1,0,0,-0.007751027598355844,1,0.0
satisfied,0,0,1,0.007574867880211391,1,0.0
rattles,0,0,1,0.007574867880211391,1,0.0
zippy,0,0,3,0.022842043452730474,3,1.5849625007211563
alternating,1,0,0,-0.007751027598355844,1,0.0
sloppiness,1,0,0,-0.007751027598355844,1,0.0
ooze,1,0,0,-0.007751027598355844,1,0.0
amiable,0,0,1,0.007574867880211391,1,0.0
bullseye,0,0,1,0.007574867880211391,1,0.0
appropriated,1,0,0,-0.007751027598355844,1,0.0
playbook,1,0,0,-0.007751027598355844,1,0.0
unashamedly,1,0,0,-0.007751027598355844,1,0.0
clocks,2,0,0,-0.015443335290663537,2,1.0
80,3,0,0,-0.02313564298297123,3,1.5849625007211563
colin,1,0,0,-0.007751027598355844,1,0.0
favors,1,0,1,-0.0001174398120963021,2,1.0
dismissive,1,0,0,-0.007751027598355844,1,0.0
upscale,1,0,0,-0.007751027598355844,1,0.0
dateflick,1,0,0,-0.007751027598355844,1,0.0
essential,1,0,2,0.0075161479741632405,3,1.5849625007211563
juice,1,0,1,-0.0001174398120963021,2,1.0
lodging,1,0,0,-0.007751027598355844,1,0.0
drifts,1,0,0,-0.007751027598355844,1,0.0
unmemorable,1,0,0,-0.007751027598355844,1,0.0
unembarrassing,1,0,0,-0.007751027598355844,1,0.0
barrels,1,0,0,-0.007751027598355844,1,0.0
whoopee,0,0,1,0.007574867880211391,1,0.0
aimed,1,0,1,-0.0001174398120963021,2,1.0
cushion,0,0,1,0.007574867880211391,1,0.0
ease,1,0,2,0.0075161479741632405,3,1.5849625007211563
resemble,0,0,1,0.007574867880211391,1,0.0
fisk,0,0,1,0.007574867880211391,1,0.0
modestly,0,0,1,0.007574867880211391,1,0.0
peachy,0,0,1,0.007574867880211391,1,0.0
harvest,0,0,1,0.007574867880211391,1,0.0
releases,0,0,1,0.007574867880211391,1,0.0
withered,0,0,1,0.007574867880211391,1,0.0
arriving,0,0,1,0.007574867880211391,1,0.0
sketchiest,1,0,0,-0.007751027598355844,1,0.0
aspiring,1,0,0,-0.007751027598355844,1,0.0
dumbest,1,0,0,-0.007751027598355844,1,0.0
whitaker,0,0,1,0.007574867880211391,1,0.0
protecting,0,0,1,0.007574867880211391,1,0.0
lioness,0,0,1,0.007574867880211391,1,0.0
cub,0,0,1,0.007574867880211391,1,0.0
sweat,0,0,2,0.015208455666470933,2,1.0
sucking,1,0,1,-0.0001174398120963021,2,1.0
inspirado,0,0,1,0.007574867880211391,1,0.0
fincher,2,0,5,0.022724603640634174,7,2.807354922057604
momento,0,0,2,0.015208455666470933,2,1.0
elegant,0,0,2,0.015208455666470933,2,1.0
exhaustion,1,0,0,-0.007751027598355844,1,0.0
physically,0,0,1,0.007574867880211391,1,0.0
emotively,0,0,1,0.007574867880211391,1,0.0
marshaled,1,0,1,-0.0001174398120963021,2,1.0
mastery,0,0,1,0.007574867880211391,1,0.0
crackerjack,0,0,1,0.007574867880211391,1,0.0
involves,0,0,1,0.007574867880211391,1,0.0
snazzy,0,0,1,0.007574867880211391,1,0.0
witlessness,1,0,0,-0.007751027598355844,1,0.0
110,1,0,1,-0.0001174398120963021,2,1.0
criminals,1,0,0,-0.007751027598355844,1,0.0
characteristically,0,0,1,0.007574867880211391,1,0.0
physics,0,0,1,0.007574867880211391,1,0.0
willingness,0,0,2,0.015208455666470933,2,1.0
riveted,0,0,1,0.007574867880211391,1,0.0
refried,1,0,0,-0.007751027598355844,1,0.0
intriguedbut,1,0,0,-0.007751027598355844,1,0.0
reasonable,1,0,2,0.0075161479741632405,3,1.5849625007211563
koepp,2,0,1,-0.007809747504403995,3,1.5849625007211563
limits,0,0,1,0.007574867880211391,1,0.0
rosemary,1,0,0,-0.007751027598355844,1,0.0
extremities,0,0,1,0.007574867880211391,1,0.0
sweaty,0,0,1,0.007574867880211391,1,0.0
palmed,0,0,1,0.007574867880211391,1,0.0
unsurprising,2,0,0,-0.015443335290663537,2,1.0
moderately,2,0,0,-0.015443335290663537,2,1.0
illuminated,0,0,1,0.007574867880211391,1,0.0
focused,1,0,1,-0.0001174398120963021,2,1.0
shards,0,0,1,0.007574867880211391,1,0.0
bends,0,0,1,0.007574867880211391,1,0.0
skirmishes,1,0,0,-0.007751027598355844,1,0.0
predators,1,0,0,-0.007751027598355844,1,0.0
waged,1,0,0,-0.007751027598355844,1,0.0
whopping,0,0,1,0.007574867880211391,1,0.0
hangover,2,0,1,-0.007809747504403995,3,1.5849625007211563
cheat,0,0,1,0.007574867880211391,1,0.0
jolt,0,0,1,0.007574867880211391,1,0.0
pinocchio,13,0,0,-0.10005871990604816,13,3.700439718141092
lists,1,0,0,-0.007751027598355844,1,0.0
grocery,1,0,0,-0.007751027598355844,1,0.0
stagecrafts,1,0,0,-0.007751027598355844,1,0.0
therefore,1,0,0,-0.007751027598355844,1,0.0
bolder,1,0,0,-0.007751027598355844,1,0.0
overwhelms,1,0,1,-0.0001174398120963021,2,1.0
stockings,1,0,0,-0.007751027598355844,1,0.0
benigni,14,0,0,-0.10775102759835585,14,3.8073549220576037
perennial,1,0,0,-0.007751027598355844,1,0.0
fanciful,1,0,0,-0.007751027598355844,1,0.0
monosyllabic,1,0,0,-0.007751027598355844,1,0.0
dubbed,2,0,0,-0.015443335290663537,2,1.0
chalk,1,0,1,-0.0001174398120963021,2,1.0
hubristic,1,0,0,-0.007751027598355844,1,0.0
breckin,2,0,0,-0.015443335290663537,2,1.0
meyer,2,0,1,-0.007809747504403995,3,1.5849625007211563
countenance,1,0,0,-0.007751027598355844,1,0.0
receding,1,0,0,-0.007751027598355844,1,0.0
weathered,1,0,0,-0.007751027598355844,1,0.0
hairline,1,0,0,-0.007751027598355844,1,0.0
stuffing,1,0,0,-0.007751027598355844,1,0.0
hmmm,1,0,0,-0.007751027598355844,1,0.0
sharpener,1,0,0,-0.007751027598355844,1,0.0
define,1,0,1,-0.0001174398120963021,2,1.0
hamlet,1,0,0,-0.007751027598355844,1,0.0
iv,1,0,0,-0.007751027598355844,1,0.0
shakespeare,1,0,0,-0.007751027598355844,1,0.0
anthropomorphic,1,0,0,-0.007751027598355844,1,0.0
subtitles,1,0,0,-0.007751027598355844,1,0.0
debt,1,0,1,-0.0001174398120963021,2,1.0
vanity,1,0,0,-0.007751027598355844,1,0.0
owed,1,0,0,-0.007751027598355844,1,0.0
frightful,1,0,0,-0.007751027598355844,1,0.0
roberto,3,0,0,-0.02313564298297123,3,1.5849625007211563
danilo,1,0,0,-0.007751027598355844,1,0.0
spinotti,1,0,0,-0.007751027598355844,1,0.0
insisted,1,0,0,-0.007751027598355844,1,0.0
luscious,1,0,0,-0.007751027598355844,1,0.0
donati,1,0,0,-0.007751027598355844,1,0.0
designs,1,0,0,-0.007751027598355844,1,0.0
philbin,1,0,0,-0.007751027598355844,1,0.0
regis,1,0,0,-0.007751027598355844,1,0.0
glenn,1,0,0,-0.007751027598355844,1,0.0
surreal,1,0,1,-0.0001174398120963021,2,1.0
dubbing,1,0,0,-0.007751027598355844,1,0.0
log,1,0,0,-0.007751027598355844,1,0.0
balding,1,0,0,-0.007751027598355844,1,0.0
assign,1,0,0,-0.007751027598355844,1,0.0
dressed,1,0,0,-0.007751027598355844,1,0.0
jammies,1,0,0,-0.007751027598355844,1,0.0
wreckage,1,0,0,-0.007751027598355844,1,0.0
49,1,0,0,-0.007751027598355844,1,0.0
cowrote,1,0,0,-0.007751027598355844,1,0.0
starred,2,0,0,-0.015443335290663537,2,1.0
wrote,3,0,0,-0.02313564298297123,3,1.5849625007211563
tall,1,0,1,-0.0001174398120963021,2,1.0
skips,1,0,0,-0.007751027598355844,1,0.0
manchild,1,0,0,-0.007751027598355844,1,0.0
sandlerian,1,0,0,-0.007751027598355844,1,0.0
undercut,2,0,0,-0.015443335290663537,2,1.0
nincompoop,1,0,0,-0.007751027598355844,1,0.0
variant,1,0,0,-0.007751027598355844,1,0.0
stilted,2,0,0,-0.015443335290663537,2,1.0
nightmares,1,0,0,-0.007751027598355844,1,0.0
felinni,1,0,0,-0.007751027598355844,1,0.0
freakshow,1,0,0,-0.007751027598355844,1,0.0
labute,2,0,6,0.030358191426893714,8,3.0
drew,1,0,1,-0.0001174398120963021,2,1.0
nancy,0,0,1,0.007574867880211391,1,0.0
browning,0,0,1,0.007574867880211391,1,0.0
barrett,0,0,1,0.007574867880211391,1,0.0
hmm,0,0,1,0.007574867880211391,1,0.0
possession,1,0,6,0.03805049911920141,7,2.807354922057604
underpinnings,0,0,1,0.007574867880211391,1,0.0
handling,0,0,2,0.015208455666470933,2,1.0
poetry,3,0,1,-0.015502055196711688,4,2.0
byatt,1,0,2,0.0075161479741632405,3,1.5849625007211563
joys,0,0,2,0.015208455666470933,2,1.0
bones,1,0,0,-0.007751027598355844,1,0.0
purposes,1,0,1,-0.0001174398120963021,2,1.0
bare,1,0,3,0.015149735760422781,4,2.0
extracting,1,0,0,-0.007751027598355844,1,0.0
victorians,1,0,0,-0.007751027598355844,1,0.0
companion,0,0,1,0.007574867880211391,1,0.0
dusty,1,0,0,-0.007751027598355844,1,0.0
tools,0,0,1,0.007574867880211391,1,0.0
nudity,0,0,1,0.007574867880211391,1,0.0
problematic,1,0,1,-0.0001174398120963021,2,1.0
romantichugely,0,0,1,0.007574867880211391,1,0.0
prim,0,0,1,0.007574867880211391,1,0.0
exterior,1,0,1,-0.0001174398120963021,2,1.0
filmelegant,0,0,1,0.007574867880211391,1,0.0
balances,0,0,2,0.015208455666470933,2,1.0
genitals,1,0,0,-0.007751027598355844,1,0.0
torturing,1,0,0,-0.007751027598355844,1,0.0
packaged,1,0,0,-0.007751027598355844,1,0.0
musty,1,0,0,-0.007751027598355844,1,0.0
uptight,1,0,0,-0.007751027598355844,1,0.0
showcases,0,0,3,0.022842043452730474,3,1.5849625007211563
novelist,0,0,1,0.007574867880211391,1,0.0
somnolent,1,0,0,-0.007751027598355844,1,0.0
mummified,1,0,0,-0.007751027598355844,1,0.0
upsets,1,0,0,-0.007751027598355844,1,0.0
shreds,1,0,0,-0.007751027598355844,1,0.0
unknowable,0,0,1,0.007574867880211391,1,0.0
neater,0,0,1,0.007574867880211391,1,0.0
kindred,0,0,1,0.007574867880211391,1,0.0
honorable,1,0,1,-0.0001174398120963021,2,1.0
frosty,1,0,0,-0.007751027598355844,1,0.0
authenticate,1,0,0,-0.007751027598355844,1,0.0
recovers,1,0,0,-0.007751027598355844,1,0.0
paltrow,1,0,0,-0.007751027598355844,1,0.0
abroad,1,0,0,-0.007751027598355844,1,0.0
rapturous,0,0,1,0.007574867880211391,1,0.0
spiced,0,0,2,0.015208455666470933,2,1.0
skullduggery,0,0,1,0.007574867880211391,1,0.0
fairytale,0,0,1,0.007574867880211391,1,0.0
harris,2,0,0,-0.015443335290663537,2,1.0
disabilities,1,0,0,-0.007751027598355844,1,0.0
fatally,1,0,0,-0.007751027598355844,1,0.0
overlongit,1,0,0,-0.007751027598355844,1,0.0
degenerating,1,0,0,-0.007751027598355844,1,0.0
pious,1,0,0,-0.007751027598355844,1,0.0
therapeutic,1,0,0,-0.007751027598355844,1,0.0
zap,1,0,0,-0.007751027598355844,1,0.0
butalso,0,0,1,0.007574867880211391,1,0.0
destination,1,0,1,-0.0001174398120963021,2,1.0
undetermined,1,0,0,-0.007751027598355844,1,0.0
pitifully,1,0,0,-0.007751027598355844,1,0.0
broder,2,0,0,-0.015443335290663537,2,1.0
dances,0,0,1,0.007574867880211391,1,0.0
oeuvre,1,0,0,-0.007751027598355844,1,0.0
farrelly,3,0,0,-0.02313564298297123,3,1.5849625007211563
christina,1,0,0,-0.007751027598355844,1,0.0
ricci,1,0,0,-0.007751027598355844,1,0.0
miracles,1,0,0,-0.007751027598355844,1,0.0
flip,1,0,0,-0.007751027598355844,1,0.0
discarded,1,0,0,-0.007751027598355844,1,0.0
lobotomy,1,0,0,-0.007751027598355844,1,0.0
scooped,1,0,0,-0.007751027598355844,1,0.0
lantern,1,0,0,-0.007751027598355844,1,0.0
blended,0,0,1,0.007574867880211391,1,0.0
huckster,1,0,0,-0.007751027598355844,1,0.0
struts,1,0,0,-0.007751027598355844,1,0.0
lapel,1,0,0,-0.007751027598355844,1,0.0
pinned,1,0,0,-0.007751027598355844,1,0.0
decorates,1,0,0,-0.007751027598355844,1,0.0
wives,1,0,0,-0.007751027598355844,1,0.0
stepford,1,0,0,-0.007751027598355844,1,0.0
exceed,1,0,0,-0.007751027598355844,1,0.0
abilities,1,0,0,-0.007751027598355844,1,0.0
fraternity,2,0,0,-0.015443335290663537,2,1.0
ambitions,2,0,0,-0.015443335290663537,2,1.0
larson,1,0,0,-0.007751027598355844,1,0.0
abrams,1,0,0,-0.007751027598355844,1,0.0
pointed,0,0,1,0.007574867880211391,1,0.0
callow,1,0,0,-0.007751027598355844,1,0.0
solondzian,1,0,0,-0.007751027598355844,1,0.0
mirthless,1,0,0,-0.007751027598355844,1,0.0
enron,1,0,0,-0.007751027598355844,1,0.0
congratulation,1,0,0,-0.007751027598355844,1,0.0
declares,0,0,1,0.007574867880211391,1,0.0
sweetest,0,0,2,0.015208455666470933,2,1.0
defenders,0,0,1,0.007574867880211391,1,0.0
staunchest,0,0,1,0.007574867880211391,1,0.0
feints,0,0,1,0.007574867880211391,1,0.0
jabs,0,0,3,0.022842043452730474,3,1.5849625007211563
smash,2,0,0,-0.015443335290663537,2,1.0
singular,0,0,1,0.007574867880211391,1,0.0
unexplored,1,0,1,-0.0001174398120963021,2,1.0
dingbat,0,0,1,0.007574867880211391,1,0.0
contained,0,0,1,0.007574867880211391,1,0.0
structured,0,0,3,0.022842043452730474,3,1.5849625007211563
equalizer,0,0,1,0.007574867880211391,1,0.0
ills,0,0,1,0.007574867880211391,1,0.0
grandness,0,0,1,0.007574867880211391,1,0.0
moustache,0,0,1,0.007574867880211391,1,0.0
milk,1,0,1,-0.0001174398120963021,2,1.0
kilter,1,0,0,-0.007751027598355844,1,0.0
unengaging,1,0,0,-0.007751027598355844,1,0.0
swoony,0,0,1,0.007574867880211391,1,0.0
catastrophe,0,0,1,0.007574867880211391,1,0.0
cockamamie,0,0,1,0.007574867880211391,1,0.0
poem,0,0,2,0.015208455666470933,2,1.0
precipitously,0,0,1,0.007574867880211391,1,0.0
wracking,0,0,1,0.007574867880211391,1,0.0
screamingly,0,0,1,0.007574867880211391,1,0.0
lyricism,0,0,1,0.007574867880211391,1,0.0
dolts,0,0,1,0.007574867880211391,1,0.0
honey,0,0,1,0.007574867880211391,1,0.0
controlled,0,0,2,0.015208455666470933,2,1.0
panicky,0,0,1,0.007574867880211391,1,0.0
placed,0,0,2,0.015208455666470933,2,1.0
constraints,0,0,1,0.007574867880211391,1,0.0
captivated,0,0,1,0.007574867880211391,1,0.0
inclination,2,0,1,-0.007809747504403995,3,1.5849625007211563
lick,1,0,1,-0.0001174398120963021,2,1.0
undeveloped,1,0,0,-0.007751027598355844,1,0.0
arresting,0,0,1,0.007574867880211391,1,0.0
subdued,0,0,1,0.007574867880211391,1,0.0
weirdos,0,0,1,0.007574867880211391,1,0.0
noyce,0,0,7,0.05337639459776864,7,2.807354922057604
tailored,0,0,1,0.007574867880211391,1,0.0
shameful,0,0,1,0.007574867880211391,1,0.0
antipodean,0,0,1,0.007574867880211391,1,0.0
radiates,0,0,2,0.015208455666470933,2,1.0
sampi,0,0,1,0.007574867880211391,1,0.0
everlyn,0,0,1,0.007574867880211391,1,0.0
courageous,0,0,1,0.007574867880211391,1,0.0
resourceful,0,0,2,0.015208455666470933,2,1.0
pursuers,0,0,1,0.007574867880211391,1,0.0
affectingwhile,0,0,1,0.007574867880211391,1,0.0
piercingly,0,0,1,0.007574867880211391,1,0.0
basis,1,0,1,-0.0001174398120963021,2,1.0
embellishment,0,0,1,0.007574867880211391,1,0.0
shocking,0,0,2,0.015208455666470933,2,1.0
colonialism,0,0,1,0.007574867880211391,1,0.0
seethes,0,0,1,0.007574867880211391,1,0.0
fulfilling,0,0,1,0.007574867880211391,1,0.0
characterisations,0,0,1,0.007574867880211391,1,0.0
compressed,0,0,1,0.007574867880211391,1,0.0
dismay,0,0,1,0.007574867880211391,1,0.0
adequately,0,0,1,0.007574867880211391,1,0.0
desolation,0,0,1,0.007574867880211391,1,0.0
rings,1,0,1,-0.0001174398120963021,2,1.0
shoulders,0,0,2,0.015208455666470933,2,1.0
societal,0,0,1,0.007574867880211391,1,0.0
persistence,0,0,1,0.007574867880211391,1,0.0
testimony,0,0,1,0.007574867880211391,1,0.0
breakingly,0,0,1,0.007574867880211391,1,0.0
illuminate,0,0,1,0.007574867880211391,1,0.0
patriot,0,0,1,0.007574867880211391,1,0.0
dinner,0,0,1,0.007574867880211391,1,0.0
immediate,1,0,1,-0.0001174398120963021,2,1.0
capitalize,1,0,0,-0.007751027598355844,1,0.0
exists,2,0,0,-0.015443335290663537,2,1.0
magnetic,0,0,1,0.007574867880211391,1,0.0
wanders,1,0,0,-0.007751027598355844,1,0.0
recite,2,0,0,-0.015443335290663537,2,1.0
distanced,1,0,0,-0.007751027598355844,1,0.0
brett,1,0,1,-0.0001174398120963021,2,1.0
ratner,1,0,1,-0.0001174398120963021,2,1.0
lambs,1,0,5,0.030416911332941866,6,2.584962500721156
eyeball,0,0,2,0.015208455666470933,2,1.0
toe,0,0,2,0.015208455666470933,2,1.0
interacting,0,0,1,0.007574867880211391,1,0.0
noses,0,0,1,0.007574867880211391,1,0.0
superficiality,1,0,0,-0.007751027598355844,1,0.0
adaptationjust,0,0,1,0.007574867880211391,1,0.0
manhunter,0,0,2,0.015208455666470933,2,1.0
ecstatic,0,0,2,0.015208455666470933,2,1.0
deciding,0,0,1,0.007574867880211391,1,0.0
cuisine,0,0,1,0.007574867880211391,1,0.0
bon,0,0,2,0.015208455666470933,2,1.0
meal,0,0,1,0.007574867880211391,1,0.0
certified,0,0,1,0.007574867880211391,1,0.0
appétit,0,0,1,0.007574867880211391,1,0.0
rates,0,0,1,0.007574867880211391,1,0.0
exceptional,0,0,2,0.015208455666470933,2,1.0
abysmal,0,0,1,0.007574867880211391,1,0.0
terror,1,0,2,0.0075161479741632405,3,1.5849625007211563
bowel,0,0,1,0.007574867880211391,1,0.0
stopping,0,0,1,0.007574867880211391,1,0.0
failings,1,0,1,-0.0001174398120963021,2,1.0
inferior,0,0,1,0.007574867880211391,1,0.0
prequel,1,0,0,-0.007751027598355844,1,0.0
tightening,0,0,1,0.007574867880211391,1,0.0
duplicate,0,0,1,0.007574867880211391,1,0.0
showy,0,0,1,0.007574867880211391,1,0.0
baroque,0,0,1,0.007574867880211391,1,0.0
creepiness,0,0,2,0.015208455666470933,2,1.0
profits,0,0,1,0.007574867880211391,1,0.0
eagerness,0,0,1,0.007574867880211391,1,0.0
unity,1,0,0,-0.007751027598355844,1,0.0
admiring,1,0,0,-0.007751027598355844,1,0.0
transports,1,0,1,-0.0001174398120963021,2,1.0
cultist,0,0,1,0.007574867880211391,1,0.0
completist,0,0,1,0.007574867880211391,1,0.0
sadistic,1,0,0,-0.007751027598355844,1,0.0
repulsively,1,0,0,-0.007751027598355844,1,0.0
midway,1,0,0,-0.007751027598355844,1,0.0
flickering,1,0,0,-0.007751027598355844,1,0.0
perfunctory,2,0,0,-0.015443335290663537,2,1.0
cravings,0,0,1,0.007574867880211391,1,0.0
dual,0,0,1,0.007574867880211391,1,0.0
morbid,0,0,1,0.007574867880211391,1,0.0
dragons,5,0,4,-0.007985907222548445,9,3.1699250014423126
reheated,0,0,1,0.007574867880211391,1,0.0
okay,1,0,0,-0.007751027598355844,1,0.0
blimey,1,0,0,-0.007751027598355844,1,0.0
hairdo,1,0,0,-0.007751027598355844,1,0.0
cor,1,0,0,-0.007751027598355844,1,0.0
cockney,1,0,0,-0.007751027598355844,1,0.0
clad,1,0,0,-0.007751027598355844,1,0.0
grunge,1,0,0,-0.007751027598355844,1,0.0
luv,1,0,0,-0.007751027598355844,1,0.0
gandalf,1,0,0,-0.007751027598355844,1,0.0
weaponry,1,0,1,-0.0001174398120963021,2,1.0
dungeons,0,0,1,0.007574867880211391,1,0.0
toss,1,0,2,0.0075161479741632405,3,1.5849625007211563
dig,1,0,1,-0.0001174398120963021,2,1.0
barbecue,0,0,1,0.007574867880211391,1,0.0
wisecracking,1,0,0,-0.007751027598355844,1,0.0
decision,0,0,1,0.007574867880211391,1,0.0
divers,0,0,1,0.007574867880211391,1,0.0
unrealized,0,0,1,0.007574867880211391,1,0.0
warrior,0,0,3,0.022842043452730474,3,1.5849625007211563
swaggering,1,0,0,-0.007751027598355844,1,0.0
laughingly,1,0,0,-0.007751027598355844,1,0.0
heaviest,1,0,0,-0.007751027598355844,1,0.0
smothered,1,0,0,-0.007751027598355844,1,0.0
imagines,0,0,1,0.007574867880211391,1,0.0
pike,0,0,1,0.007574867880211391,1,0.0
guardsman,0,0,1,0.007574867880211391,1,0.0
chested,0,0,1,0.007574867880211391,1,0.0
draggin,1,0,0,-0.007751027598355844,1,0.0
apocalypse,0,0,1,0.007574867880211391,1,0.0
hodgepodge,1,0,0,-0.007751027598355844,1,0.0
pose,2,0,0,-0.015443335290663537,2,1.0
mythology,2,0,0,-0.015443335290663537,2,1.0
neatly,0,0,2,0.015208455666470933,2,1.0
ravaged,1,0,1,-0.0001174398120963021,2,1.0
assailants,1,0,0,-0.007751027598355844,1,0.0
winged,1,0,0,-0.007751027598355844,1,0.0
batting,1,0,0,-0.007751027598355844,1,0.0
eyelids,1,0,0,-0.007751027598355844,1,0.0
postapocalyptic,1,0,0,-0.007751027598355844,1,0.0
disadvantage,1,0,0,-0.007751027598355844,1,0.0
debts,0,0,1,0.007574867880211391,1,0.0
cardboard,1,0,0,-0.007751027598355844,1,0.0
thinner,1,0,0,-0.007751027598355844,1,0.0
295,1,0,0,-0.007751027598355844,1,0.0
preemptive,2,0,0,-0.015443335290663537,2,1.0
indignant,1,0,0,-0.007751027598355844,1,0.0
repellent,1,0,0,-0.007751027598355844,1,0.0
campy,2,0,0,-0.015443335290663537,2,1.0
leaning,1,0,0,-0.007751027598355844,1,0.0
limitations,1,0,0,-0.007751027598355844,1,0.0
enhance,1,0,0,-0.007751027598355844,1,0.0
zombie,2,0,0,-0.015443335290663537,2,1.0
resign,0,0,1,0.007574867880211391,1,0.0
hysteria,1,0,0,-0.007751027598355844,1,0.0
playstation,1,0,0,-0.007751027598355844,1,0.0
eliminating,1,0,0,-0.007751027598355844,1,0.0
beheadings,1,0,0,-0.007751027598355844,1,0.0
spending,1,0,1,-0.0001174398120963021,2,1.0
00,1,0,0,-0.007751027598355844,1,0.0
preferred,1,0,0,-0.007751027598355844,1,0.0
linearity,0,0,1,0.007574867880211391,1,0.0
upfront,0,0,1,0.007574867880211391,1,0.0
dispatching,0,0,1,0.007574867880211391,1,0.0
seated,1,0,0,-0.007751027598355844,1,0.0
luckiest,1,0,0,-0.007751027598355844,1,0.0
pinheads,1,0,0,-0.007751027598355844,1,0.0
ignorant,1,0,0,-0.007751027598355844,1,0.0
milla,0,0,1,0.007574867880211391,1,0.0
invaders,1,0,0,-0.007751027598355844,1,0.0
existent,1,0,0,-0.007751027598355844,1,0.0
boils,1,0,0,-0.007751027598355844,1,0.0
trains,1,0,0,-0.007751027598355844,1,0.0
videogame,1,0,0,-0.007751027598355844,1,0.0
relentlessness,1,0,0,-0.007751027598355844,1,0.0
impersonal,1,0,0,-0.007751027598355844,1,0.0
began,1,0,0,-0.007751027598355844,1,0.0
morphed,1,0,0,-0.007751027598355844,1,0.0
wrenches,1,0,0,-0.007751027598355844,1,0.0
sanctified,1,0,0,-0.007751027598355844,1,0.0
alarmed,1,0,0,-0.007751027598355844,1,0.0
fleeing,1,0,0,-0.007751027598355844,1,0.0
doors,1,0,0,-0.007751027598355844,1,0.0
radiant,1,0,0,-0.007751027598355844,1,0.0
bloodbath,1,0,0,-0.007751027598355844,1,0.0
requirement,0,0,1,0.007574867880211391,1,0.0
barrie,1,0,1,-0.0001174398120963021,2,1.0
unessential,1,0,0,-0.007751027598355844,1,0.0
instant,1,0,1,-0.0001174398120963021,2,1.0
occasions,0,0,1,0.007574867880211391,1,0.0
cracked,0,0,1,0.007574867880211391,1,0.0
rake,0,0,1,0.007574867880211391,1,0.0
boomer,0,0,1,0.007574867880211391,1,0.0
softens,1,0,0,-0.007751027598355844,1,0.0
instance,1,0,0,-0.007751027598355844,1,0.0
indians,1,0,1,-0.0001174398120963021,2,1.0
portraits,1,0,0,-0.007751027598355844,1,0.0
giants,1,0,0,-0.007751027598355844,1,0.0
tune,1,0,0,-0.007751027598355844,1,0.0
tuneless,1,0,0,-0.007751027598355844,1,0.0
ink,1,0,0,-0.007751027598355844,1,0.0
provided,1,0,1,-0.0001174398120963021,2,1.0
pixie,0,0,1,0.007574867880211391,1,0.0
fondly,0,0,1,0.007574867880211391,1,0.0
dishonor,1,0,0,-0.007751027598355844,1,0.0
exude,1,0,1,-0.0001174398120963021,2,1.0
distinct,0,0,3,0.022842043452730474,3,1.5849625007211563
dealt,0,0,1,0.007574867880211391,1,0.0
wartime,1,0,1,-0.0001174398120963021,2,1.0
notice,2,0,3,0.0074574280681150885,5,2.321928094887362
bedknobs,0,0,1,0.007574867880211391,1,0.0
rediscovering,0,0,1,0.007574867880211391,1,0.0
broomsticks,0,0,1,0.007574867880211391,1,0.0
1971,0,0,1,0.007574867880211391,1,0.0
lush,1,0,0,-0.007751027598355844,1,0.0
neverland,2,0,0,-0.015443335290663537,2,1.0
backdrops,1,0,0,-0.007751027598355844,1,0.0
insatiable,1,0,0,-0.007751027598355844,1,0.0
shelved,1,0,0,-0.007751027598355844,1,0.0
1954,1,0,0,-0.007751027598355844,1,0.0
straddle,1,0,0,-0.007751027598355844,1,0.0
ransacks,1,0,0,-0.007751027598355844,1,0.0
archives,1,0,0,-0.007751027598355844,1,0.0
buck,1,0,0,-0.007751027598355844,1,0.0
warmly,0,0,1,0.007574867880211391,1,0.0
pluto,0,0,1,0.007574867880211391,1,0.0
preceded,0,0,1,0.007574867880211391,1,0.0
nostalgic,0,0,1,0.007574867880211391,1,0.0
preschool,0,0,1,0.007574867880211391,1,0.0
worry,1,0,2,0.0075161479741632405,3,1.5849625007211563
tots,1,0,0,-0.007751027598355844,1,0.0
1953,1,0,0,-0.007751027598355844,1,0.0
reverent,0,0,1,0.007574867880211391,1,0.0
reliable,0,0,1,0.007574867880211391,1,0.0
cleavage,0,0,1,0.007574867880211391,1,0.0
principled,0,0,1,0.007574867880211391,1,0.0
ou,0,0,1,0.007574867880211391,1,0.0
feisty,0,0,1,0.007574867880211391,1,0.0
remain,2,0,0,-0.015443335290663537,2,1.0
agape,1,0,0,-0.007751027598355844,1,0.0
punched,1,0,0,-0.007751027598355844,1,0.0
pr,1,0,0,-0.007751027598355844,1,0.0
mendes,2,0,4,0.015091015854374633,6,2.584962500721156
arrogance,0,0,1,0.007574867880211391,1,0.0
perdition,2,0,3,0.0074574280681150885,5,2.321928094887362
defects,0,0,1,0.007574867880211391,1,0.0
familia,0,0,1,0.007574867880211391,1,0.0
traición,0,0,1,0.007574867880211391,1,0.0
lealtad,0,0,1,0.007574867880211391,1,0.0
seguramente,0,0,1,0.007574867880211391,1,0.0
historia,0,0,1,0.007574867880211391,1,0.0
amor,0,0,1,0.007574867880211391,1,0.0
convertirá,0,0,1,0.007574867880211391,1,0.0
gran,0,0,1,0.007574867880211391,1,0.0
nuevo,0,0,1,0.007574867880211391,1,0.0
utilized,0,0,1,0.007574867880211391,1,0.0
unforgiven,0,0,1,0.007574867880211391,1,0.0
1992,0,0,1,0.007574867880211391,1,0.0
scintillating,0,0,1,0.007574867880211391,1,0.0
sparse,0,0,1,0.007574867880211391,1,0.0
concentrates,0,0,1,0.007574867880211391,1,0.0
sway,1,0,1,-0.0001174398120963021,2,1.0
revigorates,0,0,1,0.007574867880211391,1,0.0
daisy,1,0,0,-0.007751027598355844,1,0.0
rests,0,0,1,0.007574867880211391,1,0.0
panache,0,0,1,0.007574867880211391,1,0.0
oscura,0,0,1,0.007574867880211391,1,0.0
precisa,0,0,1,0.007574867880211391,1,0.0
grandiosa,0,0,1,0.007574867880211391,1,0.0
siempre,0,0,1,0.007574867880211391,1,0.0
conmovedora,0,0,1,0.007574867880211391,1,0.0
casi,0,0,1,0.007574867880211391,1,0.0
momentos,1,0,1,-0.0001174398120963021,2,1.0
vicarious,1,0,0,-0.007751027598355844,1,0.0
overrides,1,0,0,-0.007751027598355844,1,0.0
gump,1,0,0,-0.007751027598355844,1,0.0
forrest,1,0,0,-0.007751027598355844,1,0.0
sophomore,0,0,1,0.007574867880211391,1,0.0
segues,0,0,1,0.007574867880211391,1,0.0
sleight,0,0,1,0.007574867880211391,1,0.0
slump,0,0,1,0.007574867880211391,1,0.0
scrubbing,0,0,1,0.007574867880211391,1,0.0
benchmark,0,0,1,0.007574867880211391,1,0.0
exquisitely,0,0,2,0.015208455666470933,2,1.0
rigorously,0,0,1,0.007574867880211391,1,0.0
valedictorian,1,0,0,-0.007751027598355844,1,0.0
landings,1,0,0,-0.007751027598355844,1,0.0
mise,0,0,1,0.007574867880211391,1,0.0
cinephiles,0,0,1,0.007574867880211391,1,0.0
heading,1,0,1,-0.0001174398120963021,2,1.0
gaps,0,0,3,0.022842043452730474,3,1.5849625007211563
parsing,0,0,1,0.007574867880211391,1,0.0
breach,0,0,1,0.007574867880211391,1,0.0
unsentimental,0,0,1,0.007574867880211391,1,0.0
embarking,0,0,1,0.007574867880211391,1,0.0
goers,0,0,1,0.007574867880211391,1,0.0
outside,1,0,2,0.0075161479741632405,3,1.5849625007211563
collectively,0,0,1,0.007574867880211391,1,0.0
vowing,0,0,1,0.007574867880211391,1,0.0
staggering,0,0,1,0.007574867880211391,1,0.0
sergio,0,0,1,0.007574867880211391,1,0.0
uncut,0,0,1,0.007574867880211391,1,0.0
leone,0,0,1,0.007574867880211391,1,0.0
embalmed,1,0,0,-0.007751027598355844,1,0.0
continuing,0,0,1,0.007574867880211391,1,0.0
robberies,0,0,1,0.007574867880211391,1,0.0
bank,1,0,1,-0.0001174398120963021,2,1.0
hall,1,0,0,-0.007751027598355844,1,0.0
conrad,1,0,0,-0.007751027598355844,1,0.0
attractions,1,0,0,-0.007751027598355844,1,0.0
excellence,1,0,0,-0.007751027598355844,1,0.0
deserved,1,0,1,-0.0001174398120963021,2,1.0
unpredictability,0,0,1,0.007574867880211391,1,0.0
kidd,1,0,5,0.030416911332941866,6,2.584962500721156
dylan,1,0,2,0.0075161479741632405,3,1.5849625007211563
lemon,1,0,0,-0.007751027598355844,1,0.0
pill,2,0,0,-0.015443335290663537,2,1.0
sexes,0,0,1,0.007574867880211391,1,0.0
rogers,0,0,1,0.007574867880211391,1,0.0
smartest,1,0,2,0.0075161479741632405,3,1.5849625007211563
coarseness,0,0,1,0.007574867880211391,1,0.0
outlet,0,0,1,0.007574867880211391,1,0.0
knife,0,0,1,0.007574867880211391,1,0.0
ideal,0,0,2,0.015208455666470933,2,1.0
diction,0,0,1,0.007574867880211391,1,0.0
cad,0,0,2,0.015208455666470933,2,1.0
instructs,0,0,1,0.007574867880211391,1,0.0
prickly,0,0,1,0.007574867880211391,1,0.0
misanthropy,0,0,1,0.007574867880211391,1,0.0
zen,0,0,1,0.007574867880211391,1,0.0
manners,1,0,3,0.015149735760422781,4,2.0
ourside,0,0,1,0.007574867880211391,1,0.0
intolerable,1,0,1,-0.0001174398120963021,2,1.0
artistically,1,0,0,-0.007751027598355844,1,0.0
opacity,1,0,0,-0.007751027598355844,1,0.0
baca,1,0,0,-0.007751027598355844,1,0.0
annoyingly,1,0,0,-0.007751027598355844,1,0.0
vertigo,1,0,0,-0.007751027598355844,1,0.0
asay,1,0,0,-0.007751027598355844,1,0.0
joaquin,1,0,0,-0.007751027598355844,1,0.0
frailty,0,0,1,0.007574867880211391,1,0.0
fascinates,0,0,1,0.007574867880211391,1,0.0
voyeur,0,0,1,0.007574867880211391,1,0.0
eavesdropping,0,0,1,0.007574867880211391,1,0.0
referee,0,0,1,0.007574867880211391,1,0.0
magicit,0,0,1,0.007574867880211391,1,0.0
dodge,1,0,0,-0.007751027598355844,1,0.0
franz,0,0,1,0.007574867880211391,1,0.0
rhapsodic,0,0,1,0.007574867880211391,1,0.0
oomph,0,0,1,0.007574867880211391,1,0.0
surgeon,0,0,1,0.007574867880211391,1,0.0
attitudes,0,0,1,0.007574867880211391,1,0.0
egoism,0,0,1,0.007574867880211391,1,0.0
tumor,0,0,1,0.007574867880211391,1,0.0
exposes,0,0,2,0.015208455666470933,2,1.0
weave,0,0,2,0.015208455666470933,2,1.0
bop,0,0,1,0.007574867880211391,1,0.0
loquacious,0,0,1,0.007574867880211391,1,0.0
nighttime,0,0,1,0.007574867880211391,1,0.0
videologue,0,0,1,0.007574867880211391,1,0.0
fastballs,0,0,1,0.007574867880211391,1,0.0
dodger,0,0,2,0.015208455666470933,2,1.0
lothario,0,0,1,0.007574867880211391,1,0.0
disturbed,0,0,1,0.007574867880211391,1,0.0
variations,0,0,1,0.007574867880211391,1,0.0
eisenberg,0,0,1,0.007574867880211391,1,0.0
uncouth,1,0,0,-0.007751027598355844,1,0.0
sloppily,1,0,0,-0.007751027598355844,1,0.0
pit,1,0,0,-0.007751027598355844,1,0.0
loads,1,0,2,0.0075161479741632405,3,1.5849625007211563
wrestling,1,0,0,-0.007751027598355844,1,0.0
boota,1,0,0,-0.007751027598355844,1,0.0
brains,2,0,1,-0.007809747504403995,3,1.5849625007211563
velocity,1,0,0,-0.007751027598355844,1,0.0
brawn,2,0,0,-0.015443335290663537,2,1.0
fecespositively,1,0,0,-0.007751027598355844,1,0.0
elephant,1,0,0,-0.007751027598355844,1,0.0
ironically,1,0,0,-0.007751027598355844,1,0.0
railing,1,0,0,-0.007751027598355844,1,0.0
yahoo,1,0,0,-0.007751027598355844,1,0.0
ing,1,0,0,-0.007751027598355844,1,0.0
multitude,1,0,0,-0.007751027598355844,1,0.0
irredeemably,1,0,0,-0.007751027598355844,1,0.0
saddest,1,0,0,-0.007751027598355844,1,0.0
outshined,1,0,0,-0.007751027598355844,1,0.0
gobble,1,0,0,-0.007751027598355844,1,0.0
turkey,1,0,0,-0.007751027598355844,1,0.0
stereo,1,0,0,-0.007751027598355844,1,0.0
dolby,1,0,0,-0.007751027598355844,1,0.0
sanitised,1,0,0,-0.007751027598355844,1,0.0
stagey,1,0,0,-0.007751027598355844,1,0.0
gutterball,1,0,0,-0.007751027598355844,1,0.0
vain,1,0,0,-0.007751027598355844,1,0.0
trifecta,1,0,0,-0.007751027598355844,1,0.0
spiritless,1,0,0,-0.007751027598355844,1,0.0
throes,1,0,0,-0.007751027598355844,1,0.0
males,2,0,0,-0.015443335290663537,2,1.0
flush,1,0,0,-0.007751027598355844,1,0.0
derailed,1,0,0,-0.007751027598355844,1,0.0
mctiernan,2,0,0,-0.015443335290663537,2,1.0
stupider,1,0,1,-0.0001174398120963021,2,1.0
jewison,1,0,0,-0.007751027598355844,1,0.0
ultraviolent,1,0,0,-0.007751027598355844,1,0.0
robotic,1,0,0,-0.007751027598355844,1,0.0
drek,1,0,0,-0.007751027598355844,1,0.0
bots,1,0,0,-0.007751027598355844,1,0.0
comeuppance,1,0,0,-0.007751027598355844,1,0.0
slamming,0,0,1,0.007574867880211391,1,0.0
quickening,0,0,1,0.007574867880211391,1,0.0
butchered,1,0,0,-0.007751027598355844,1,0.0
robots,1,0,0,-0.007751027598355844,1,0.0
wwf,1,0,0,-0.007751027598355844,1,0.0
desperation,0,0,2,0.015208455666470933,2,1.0
deception,0,0,1,0.007574867880211391,1,0.0
delete,1,0,0,-0.007751027598355844,1,0.0
s1m0ne,0,0,1,0.007574867880211391,1,0.0
niccoldemonstrates,0,0,1,0.007574867880211391,1,0.0
wry,1,0,1,-0.0001174398120963021,2,1.0
egocentricities,0,0,1,0.007574867880211391,1,0.0
byways,0,0,1,0.007574867880211391,1,0.0
merges,0,0,1,0.007574867880211391,1,0.0
niccol,0,0,2,0.015208455666470933,2,1.0
insinuating,0,0,1,0.007574867880211391,1,0.0
symbolic,0,0,1,0.007574867880211391,1,0.0
enchantment,0,0,1,0.007574867880211391,1,0.0
facade,1,0,1,-0.0001174398120963021,2,1.0
farcelies,1,0,0,-0.007751027598355844,1,0.0
cobbled,2,0,1,-0.007809747504403995,3,1.5849625007211563
shrewd,1,0,1,-0.0001174398120963021,2,1.0
uncreative,1,0,0,-0.007751027598355844,1,0.0
steam,1,0,1,-0.0001174398120963021,2,1.0
attacking,1,0,0,-0.007751027598355844,1,0.0
thrives,0,0,1,0.007574867880211391,1,0.0
funky,0,0,1,0.007574867880211391,1,0.0
gizzard,0,0,1,0.007574867880211391,1,0.0
#,1,0,0,-0.007751027598355844,1,0.0
uncharismatically,1,0,0,-0.007751027598355844,1,0.0
résumé,1,0,0,-0.007751027598355844,1,0.0
ragbag,1,0,0,-0.007751027598355844,1,0.0
madcap,1,0,1,-0.0001174398120963021,2,1.0
staggers,1,0,0,-0.007751027598355844,1,0.0
congratulatory,1,0,0,-0.007751027598355844,1,0.0
flintstones,0,0,1,0.007574867880211391,1,0.0
crammed,1,0,1,-0.0001174398120963021,2,1.0
artless,0,0,1,0.007574867880211391,1,0.0
snacks,1,0,1,-0.0001174398120963021,2,1.0
lillard,1,0,2,0.0075161479741632405,3,1.5849625007211563
unmolested,1,0,0,-0.007751027598355844,1,0.0
marketable,1,0,0,-0.007751027598355844,1,0.0
repulse,1,0,0,-0.007751027598355844,1,0.0
zipper,1,0,0,-0.007751027598355844,1,0.0
corn,1,0,0,-0.007751027598355844,1,0.0
trudge,1,0,0,-0.007751027598355844,1,0.0
rode,1,0,0,-0.007751027598355844,1,0.0
fond,1,0,0,-0.007751027598355844,1,0.0
fanatic,1,0,0,-0.007751027598355844,1,0.0
bark,0,0,1,0.007574867880211391,1,0.0
daydreaming,1,0,0,-0.007751027598355844,1,0.0
deconstruct,1,0,0,-0.007751027598355844,1,0.0
shakespearean,1,0,0,-0.007751027598355844,1,0.0
refitting,1,0,0,-0.007751027598355844,1,0.0
nickelodeon,1,0,0,-0.007751027598355844,1,0.0
binks,1,0,0,-0.007751027598355844,1,0.0
pillowcases,1,0,0,-0.007751027598355844,1,0.0
earplugs,1,0,0,-0.007751027598355844,1,0.0
87,2,0,0,-0.015443335290663537,2,1.0
cram,1,0,0,-0.007751027598355844,1,0.0
shag,1,0,0,-0.007751027598355844,1,0.0
scoob,1,0,0,-0.007751027598355844,1,0.0
wellbut,1,0,0,-0.007751027598355844,1,0.0
counterparts,1,0,0,-0.007751027598355844,1,0.0
dooby,1,0,0,-0.007751027598355844,1,0.0
scoopers,1,0,0,-0.007751027598355844,1,0.0
pooper,1,0,0,-0.007751027598355844,1,0.0
saddles,0,0,1,0.007574867880211391,1,0.0
blazing,0,0,2,0.015208455666470933,2,1.0
televised,0,0,1,0.007574867880211391,1,0.0
reruns,1,0,1,-0.0001174398120963021,2,1.0
jaunt,0,0,1,0.007574867880211391,1,0.0
mockery,0,0,1,0.007574867880211391,1,0.0
smugness,0,0,1,0.007574867880211391,1,0.0
inserting,0,0,1,0.007574867880211391,1,0.0
hanna,2,0,0,-0.015443335290663537,2,1.0
overwhelm,1,0,0,-0.007751027598355844,1,0.0
flatulence,2,0,0,-0.015443335290663537,2,1.0
incessant,1,0,0,-0.007751027598355844,1,0.0
barbera,2,0,0,-0.015443335290663537,2,1.0
ricture,1,0,0,-0.007751027598355844,1,0.0
romething,1,0,0,-0.007751027598355844,1,0.0
roh,1,0,0,-0.007751027598355844,1,0.0
ruh,1,0,0,-0.007751027598355844,1,0.0
gilligan,1,0,0,-0.007751027598355844,1,0.0
contents,1,0,0,-0.007751027598355844,1,0.0
furnished,0,0,1,0.007574867880211391,1,0.0
casey,0,0,1,0.007574867880211391,1,0.0
shagster,0,0,1,0.007574867880211391,1,0.0
kasem,0,0,1,0.007574867880211391,1,0.0
recruiting,1,0,0,-0.007751027598355844,1,0.0
costuming,1,0,0,-0.007751027598355844,1,0.0
max,1,0,1,-0.0001174398120963021,2,1.0
playlist,1,0,0,-0.007751027598355844,1,0.0
merchandised,1,0,0,-0.007751027598355844,1,0.0
participants,1,0,1,-0.0001174398120963021,2,1.0
argue,0,0,2,0.015208455666470933,2,1.0
lesley,0,0,1,0.007574867880211391,1,0.0
shainberg,1,0,6,0.03805049911920141,7,2.807354922057604
ann,0,0,1,0.007574867880211391,1,0.0
spader,1,0,3,0.015149735760422781,4,2.0
104,0,0,1,0.007574867880211391,1,0.0
min,0,0,1,0.007574867880211391,1,0.0
jeremy,0,0,1,0.007574867880211391,1,0.0
tonality,0,0,1,0.007574867880211391,1,0.0
davies,0,0,1,0.007574867880211391,1,0.0
unfulfilling,2,0,0,-0.015443335290663537,2,1.0
whips,0,0,1,0.007574867880211391,1,0.0
chains,0,0,1,0.007574867880211391,1,0.0
fetishism,0,0,1,0.007574867880211391,1,0.0
grownups,0,0,1,0.007574867880211391,1,0.0
ofromance,0,0,1,0.007574867880211391,1,0.0
nowadays,0,0,1,0.007574867880211391,1,0.0
seduced,0,0,2,0.015208455666470933,2,1.0
buttons,0,0,1,0.007574867880211391,1,0.0
positions,0,0,1,0.007574867880211391,1,0.0
humiliation,0,0,1,0.007574867880211391,1,0.0
costars,0,0,1,0.007574867880211391,1,0.0
breakthrough,0,0,2,0.015208455666470933,2,1.0
clinic,0,0,1,0.007574867880211391,1,0.0
route,0,0,1,0.007574867880211391,1,0.0
pen,0,0,1,0.007574867880211391,1,0.0
depending,0,0,1,0.007574867880211391,1,0.0
sharpie,0,0,1,0.007574867880211391,1,0.0
freudianism,0,0,1,0.007574867880211391,1,0.0
dolorous,0,0,1,0.007574867880211391,1,0.0
dips,0,0,1,0.007574867880211391,1,0.0
sporadic,0,0,1,0.007574867880211391,1,0.0
bouquet,0,0,1,0.007574867880211391,1,0.0
flowers,0,0,1,0.007574867880211391,1,0.0
bundling,0,0,1,0.007574867880211391,1,0.0
perversity,0,0,1,0.007574867880211391,1,0.0
individuals,0,0,2,0.015208455666470933,2,1.0
intently,0,0,1,0.007574867880211391,1,0.0
tediously,1,0,0,-0.007751027598355844,1,0.0
disrespected,1,0,0,-0.007751027598355844,1,0.0
gaitskill,1,0,0,-0.007751027598355844,1,0.0
advance,2,0,0,-0.015443335290663537,2,1.0
mail,1,0,0,-0.007751027598355844,1,0.0
serve,3,0,0,-0.02313564298297123,3,1.5849625007211563
hudlin,4,0,0,-0.030827950675278923,4,2.0
stomping,1,0,0,-0.007751027598355844,1,0.0
untuned,1,0,0,-0.007751027598355844,1,0.0
instruments,1,0,0,-0.007751027598355844,1,0.0
crudity,1,0,0,-0.007751027598355844,1,0.0
tits,1,0,0,-0.007751027598355844,1,0.0
breasts,1,0,0,-0.007751027598355844,1,0.0
insipid,2,0,0,-0.015443335290663537,2,1.0
rehashed,1,0,0,-0.007751027598355844,1,0.0
waster,1,0,0,-0.007751027598355844,1,0.0
definitions,1,0,0,-0.007751027598355844,1,0.0
fleetingly,1,0,0,-0.007751027598355844,1,0.0
improvisations,1,0,0,-0.007751027598355844,1,0.0
cedric,1,0,0,-0.007751027598355844,1,0.0
accordion,1,0,0,-0.007751027598355844,1,0.0
harmonica,1,0,0,-0.007751027598355844,1,0.0
abomination,2,0,0,-0.015443335290663537,2,1.0
banjo,1,0,0,-0.007751027598355844,1,0.0
perversely,1,0,0,-0.007751027598355844,1,0.0
tome,1,0,0,-0.007751027598355844,1,0.0
dependence,1,0,0,-0.007751027598355844,1,0.0
scherick,1,0,0,-0.007751027598355844,1,0.0
ronn,1,0,0,-0.007751027598355844,1,0.0
fists,1,0,0,-0.007751027598355844,1,0.0
theatres,1,0,0,-0.007751027598355844,1,0.0
graced,1,0,0,-0.007751027598355844,1,0.0
tumbleweeds,1,0,0,-0.007751027598355844,1,0.0
reporting,1,0,0,-0.007751027598355844,1,0.0
nose,2,0,1,-0.007809747504403995,3,1.5849625007211563
turd,2,0,0,-0.015443335290663537,2,1.0
bath,1,0,0,-0.007751027598355844,1,0.0
scented,1,0,0,-0.007751027598355844,1,0.0
hawn,1,0,0,-0.007751027598355844,1,0.0
chevy,1,0,0,-0.007751027598355844,1,0.0
goldie,1,0,0,-0.007751027598355844,1,0.0
fortunately,1,0,0,-0.007751027598355844,1,0.0
boiling,1,0,0,-0.007751027598355844,1,0.0
graceless,2,0,0,-0.015443335290663537,2,1.0
slurs,1,0,0,-0.007751027598355844,1,0.0
chuckle,1,0,2,0.0075161479741632405,3,1.5849625007211563
herd,1,0,0,-0.007751027598355844,1,0.0
august,1,0,0,-0.007751027598355844,1,0.0
humidity,1,0,0,-0.007751027598355844,1,0.0
broadly,2,0,0,-0.015443335290663537,2,1.0
injured,1,0,0,-0.007751027598355844,1,0.0
tripping,0,0,1,0.007574867880211391,1,0.0
adoration,0,0,1,0.007574867880211391,1,0.0
myriad,0,0,2,0.015208455666470933,2,1.0
hotdog,2,0,0,-0.015443335290663537,2,1.0
chef,1,0,0,-0.007751027598355844,1,0.0
complaining,1,0,0,-0.007751027598355844,1,0.0
noon,1,0,0,-0.007751027598355844,1,0.0
knack,1,0,1,-0.0001174398120963021,2,1.0
demonstrated,1,0,0,-0.007751027598355844,1,0.0
blanks,1,0,0,-0.007751027598355844,1,0.0
shanghai,1,0,0,-0.007751027598355844,1,0.0
mixing,1,0,0,-0.007751027598355844,1,0.0
idiosyncratic,1,0,0,-0.007751027598355844,1,0.0
dey,2,0,0,-0.015443335290663537,2,1.0
global,0,0,1,0.007574867880211391,1,0.0
taxes,0,0,1,0.007574867880211391,1,0.0
insteadtepid,1,0,0,-0.007751027598355844,1,0.0
treated,1,0,0,-0.007751027598355844,1,0.0
tacked,1,0,0,-0.007751027598355844,1,0.0
shatner,1,0,0,-0.007751027598355844,1,0.0
chatty,1,0,0,-0.007751027598355844,1,0.0
syndrome,1,0,0,-0.007751027598355844,1,0.0
slowtime,1,0,0,-0.007751027598355844,1,0.0
abandone,0,0,1,0.007574867880211391,1,0.0
próprio,0,0,1,0.007574867880211391,1,0.0
paródia,0,0,1,0.007574867880211391,1,0.0
havia,0,0,1,0.007574867880211391,1,0.0
tarde,0,0,1,0.007574867880211391,1,0.0
clichês,0,0,1,0.007574867880211391,1,0.0
utilizar,0,0,1,0.007574867880211391,1,0.0
satirizado,0,0,1,0.007574867880211391,1,0.0
mesmos,0,0,1,0.007574867880211391,1,0.0
lampoon,0,0,1,0.007574867880211391,1,0.0
folds,1,0,0,-0.007751027598355844,1,0.0
hamming,0,0,1,0.007574867880211391,1,0.0
slapdash,2,0,0,-0.015443335290663537,2,1.0
pitiful,1,0,1,-0.0001174398120963021,2,1.0
oily,1,0,0,-0.007751027598355844,1,0.0
grinding,1,0,0,-0.007751027598355844,1,0.0
debases,1,0,0,-0.007751027598355844,1,0.0
predisposed,2,0,0,-0.015443335290663537,2,1.0
glum,2,0,0,-0.015443335290663537,2,1.0
buyers,1,0,0,-0.007751027598355844,1,0.0
starry,1,0,0,-0.007751027598355844,1,0.0
asset,1,0,0,-0.007751027598355844,1,0.0
punitive,1,0,0,-0.007751027598355844,1,0.0
smashups,1,0,0,-0.007751027598355844,1,0.0
eardrum,1,0,0,-0.007751027598355844,1,0.0
sniping,1,0,0,-0.007751027598355844,1,0.0
dicing,1,0,0,-0.007751027598355844,1,0.0
punctuation,0,0,1,0.007574867880211391,1,0.0
clutch,0,0,1,0.007574867880211391,1,0.0
gunfight,1,0,0,-0.007751027598355844,1,0.0
assaultive,1,0,0,-0.007751027598355844,1,0.0
savory,0,0,1,0.007574867880211391,1,0.0
salaries,1,0,0,-0.007751027598355844,1,0.0
cars,1,0,0,-0.007751027598355844,1,0.0
prevents,1,0,0,-0.007751027598355844,1,0.0
cylinders,1,0,0,-0.007751027598355844,1,0.0
partnering,1,0,0,-0.007751027598355844,1,0.0
surefire,1,0,1,-0.0001174398120963021,2,1.0
knowingness,1,0,0,-0.007751027598355844,1,0.0
lethal,1,0,0,-0.007751027598355844,1,0.0
emaciated,1,0,0,-0.007751027598355844,1,0.0
shyamalan,4,0,9,0.03787433940105696,13,3.700439718141092
compromise,0,0,1,0.007574867880211391,1,0.0
swathe,0,0,1,0.007574867880211391,1,0.0
retaining,0,0,1,0.007574867880211391,1,0.0
harvesting,0,0,1,0.007574867880211391,1,0.0
hints,0,0,1,0.007574867880211391,1,0.0
stepping,0,0,1,0.007574867880211391,1,0.0
rustic,0,0,1,0.007574867880211391,1,0.0
infuses,0,0,1,0.007574867880211391,1,0.0
occurrences,0,0,1,0.007574867880211391,1,0.0
buried,0,0,1,0.007574867880211391,1,0.0
então,0,0,1,0.007574867880211391,1,0.0
sinais,0,0,1,0.007574867880211391,1,0.0
começamos,0,0,1,0.007574867880211391,1,0.0
desaponta,0,0,1,0.007574867880211391,1,0.0
início,0,0,1,0.007574867880211391,1,0.0
saímos,0,0,1,0.007574867880211391,1,0.0
realmente,0,0,1,0.007574867880211391,1,0.0
problemas,0,0,1,0.007574867880211391,1,0.0
acabamos,0,0,1,0.007574867880211391,1,0.0
têm,0,0,1,0.007574867880211391,1,0.0
hitchcock,1,0,2,0.0075161479741632405,3,1.5849625007211563
occur,0,0,1,0.007574867880211391,1,0.0
gaining,0,0,1,0.007574867880211391,1,0.0
brilliantplays,0,0,1,0.007574867880211391,1,0.0
unknown,0,0,1,0.007574867880211391,1,0.0
conceptually,0,0,1,0.007574867880211391,1,0.0
suggested,0,0,1,0.007574867880211391,1,0.0
pretensions,3,0,0,-0.02313564298297123,3,1.5849625007211563
sillythe,1,0,0,-0.007751027598355844,1,0.0
misconceived,0,0,1,0.007574867880211391,1,0.0
seeping,0,0,1,0.007574867880211391,1,0.0
spirituality,0,0,2,0.015208455666470933,2,1.0
eerily,0,0,1,0.007574867880211391,1,0.0
unbreakable,1,0,0,-0.007751027598355844,1,0.0
mystic,1,0,0,-0.007751027598355844,1,0.0
staging,0,0,1,0.007574867880211391,1,0.0
elevated,0,0,1,0.007574867880211391,1,0.0
flight,1,0,0,-0.007751027598355844,1,0.0
shudder,0,0,1,0.007574867880211391,1,0.0
tremble,0,0,1,0.007574867880211391,1,0.0
significantly,1,0,1,-0.0001174398120963021,2,1.0
spoiler,1,0,0,-0.007751027598355844,1,0.0
alert,1,0,1,-0.0001174398120963021,2,1.0
exaggeration,1,0,0,-0.007751027598355844,1,0.0
skies,0,0,2,0.015208455666470933,2,1.0
bruised,0,0,1,0.007574867880211391,1,0.0
pimple,0,0,1,0.007574867880211391,1,0.0
blends,0,0,1,0.007574867880211391,1,0.0
stylishly,0,0,1,0.007574867880211391,1,0.0
absurdist,1,0,0,-0.007751027598355844,1,0.0
deliberateness,1,0,0,-0.007751027598355844,1,0.0
leavened,1,0,0,-0.007751027598355844,1,0.0
riskier,0,0,1,0.007574867880211391,1,0.0
shayamalan,1,0,0,-0.007751027598355844,1,0.0
dressing,1,0,0,-0.007751027598355844,1,0.0
eyre,4,0,4,-0.00029359953024075264,8,3.0
dramatist,1,0,0,-0.007751027598355844,1,0.0
raggedness,0,0,1,0.007574867880211391,1,0.0
paces,1,0,0,-0.007751027598355844,1,0.0
greene,0,0,4,0.03047563123899002,4,2.0
schweig,0,0,3,0.022842043452730474,3,1.5849625007211563
skins,2,0,4,0.015091015854374633,6,2.584962500721156
rez,0,0,1,0.007574867880211391,1,0.0
picnic,0,0,1,0.007574867880211391,1,0.0
laying,0,0,1,0.007574867880211391,1,0.0
harsh,0,0,1,0.007574867880211391,1,0.0
realities,0,0,1,0.007574867880211391,1,0.0
typically,0,0,1,0.007574867880211391,1,0.0
eric,0,0,1,0.007574867880211391,1,0.0
tellskins,0,0,1,0.007574867880211391,1,0.0
lodge,0,0,1,0.007574867880211391,1,0.0
clarify,0,0,1,0.007574867880211391,1,0.0
trickster,0,0,1,0.007574867880211391,1,0.0
arguments,1,0,0,-0.007751027598355844,1,0.0
tug,1,0,1,-0.0001174398120963021,2,1.0
indigenous,1,0,0,-0.007751027598355844,1,0.0
stooping,0,0,1,0.007574867880211391,1,0.0
imbued,0,0,1,0.007574867880211391,1,0.0
soothing,1,0,0,-0.007751027598355844,1,0.0
reconciliation,1,0,1,-0.0001174398120963021,2,1.0
brotherly,1,0,0,-0.007751027598355844,1,0.0
naturalism,2,0,0,-0.015443335290663537,2,1.0
fascinatingly,0,0,1,0.007574867880211391,1,0.0
humane,0,0,1,0.007574867880211391,1,0.0
yawp,1,0,0,-0.007751027598355844,1,0.0
grains,1,0,0,-0.007751027598355844,1,0.0
plight,0,0,1,0.007574867880211391,1,0.0
missive,0,0,1,0.007574867880211391,1,0.0
infuse,0,0,1,0.007574867880211391,1,0.0
desolate,0,0,1,0.007574867880211391,1,0.0
margin,0,0,1,0.007574867880211391,1,0.0
observation,2,0,0,-0.015443335290663537,2,1.0
patchy,1,0,0,-0.007751027598355844,1,0.0
sociological,1,0,0,-0.007751027598355844,1,0.0
realism,2,0,0,-0.015443335290663537,2,1.0
cathartic,0,0,1,0.007574867880211391,1,0.0
envelope,1,0,0,-0.007751027598355844,1,0.0
print,1,0,0,-0.007751027598355844,1,0.0
sleaziness,1,0,0,-0.007751027598355844,1,0.0
penis,1,0,0,-0.007751027598355844,1,0.0
pleasuring,1,0,0,-0.007751027598355844,1,0.0
incarnations,1,0,0,-0.007751027598355844,1,0.0
byzantine,1,0,0,-0.007751027598355844,1,0.0
jerking,1,0,0,-0.007751027598355844,1,0.0
elicit,3,0,1,-0.015502055196711688,4,2.0
schwartzman,2,0,0,-0.015443335290663537,2,1.0
swill,1,0,0,-0.007751027598355844,1,0.0
weaned,1,0,0,-0.007751027598355844,1,0.0
thud,1,0,0,-0.007751027598355844,1,0.0
childish,2,0,1,-0.007809747504403995,3,1.5849625007211563
slackers,3,0,1,-0.015502055196711688,4,2.0
describes,1,0,0,-0.007751027598355844,1,0.0
clunk,1,0,0,-0.007751027598355844,1,0.0
overtime,1,0,0,-0.007751027598355844,1,0.0
nicks,3,0,1,-0.015502055196711688,4,2.0
exaggerated,1,0,1,-0.0001174398120963021,2,1.0
diapers,2,0,0,-0.015443335290663537,2,1.0
gamut,1,0,0,-0.007751027598355844,1,0.0
unclean,1,0,0,-0.007751027598355844,1,0.0
booty,1,0,0,-0.007751027598355844,1,0.0
peopled,1,0,0,-0.007751027598355844,1,0.0
japanese,1,0,1,-0.0001174398120963021,2,1.0
cafeteria,1,0,0,-0.007751027598355844,1,0.0
fart,1,0,0,-0.007751027598355844,1,0.0
goulash,1,0,0,-0.007751027598355844,1,0.0
masturbation,1,0,0,-0.007751027598355844,1,0.0
steinberg,1,0,0,-0.007751027598355844,1,0.0
venality,1,0,0,-0.007751027598355844,1,0.0
confuses,1,0,0,-0.007751027598355844,1,0.0
slipshod,1,0,0,-0.007751027598355844,1,0.0
flashing,1,0,0,-0.007751027598355844,1,0.0
kinky,1,0,0,-0.007751027598355844,1,0.0
expulsion,1,0,0,-0.007751027598355844,1,0.0
unforgettably,1,0,0,-0.007751027598355844,1,0.0
uproariously,1,0,0,-0.007751027598355844,1,0.0
education,1,0,0,-0.007751027598355844,1,0.0
jokey,1,0,0,-0.007751027598355844,1,0.0
pastry,1,0,0,-0.007751027598355844,1,0.0
unmentionables,1,0,0,-0.007751027598355844,1,0.0
targets,1,0,0,-0.007751027598355844,1,0.0
violated,1,0,0,-0.007751027598355844,1,0.0
raunch,1,0,1,-0.0001174398120963021,2,1.0
farts,1,0,1,-0.0001174398120963021,2,1.0
fests,1,0,0,-0.007751027598355844,1,0.0
boobs,1,0,0,-0.007751027598355844,1,0.0
puberty,1,0,0,-0.007751027598355844,1,0.0
conceive,1,0,0,-0.007751027598355844,1,0.0
harmed,1,0,0,-0.007751027598355844,1,0.0
insulted,1,0,0,-0.007751027598355844,1,0.0
derisive,1,0,0,-0.007751027598355844,1,0.0
fixated,1,0,0,-0.007751027598355844,1,0.0
bitchy,0,0,1,0.007574867880211391,1,0.0
frolic,0,0,1,0.007574867880211391,1,0.0
lone,0,0,2,0.015208455666470933,2,1.0
piper,0,0,1,0.007574867880211391,1,0.0
perabo,0,0,1,0.007574867880211391,1,0.0
legally,1,0,2,0.0075161479741632405,3,1.5849625007211563
splittingly,0,0,1,0.007574867880211391,1,0.0
sacre,1,0,0,-0.007751027598355844,1,0.0
magnifique,1,0,0,-0.007751027598355844,1,0.0
bleu,1,0,0,-0.007751027598355844,1,0.0
adolescence,0,0,1,0.007574867880211391,1,0.0
barbs,0,0,1,0.007574867880211391,1,0.0
delectable,0,0,1,0.007574867880211391,1,0.0
shenanigans,1,0,0,-0.007751027598355844,1,0.0
mayron,0,0,1,0.007574867880211391,1,0.0
clueless,2,0,0,-0.015443335290663537,2,1.0
fork,1,0,0,-0.007751027598355844,1,0.0
gratingly,1,0,0,-0.007751027598355844,1,0.0
groaner,1,0,0,-0.007751027598355844,1,0.0
leplouff,1,0,0,-0.007751027598355844,1,0.0
creators,1,0,0,-0.007751027598355844,1,0.0
huskies,0,0,2,0.015208455666470933,2,1.0
parka,0,0,1,0.007574867880211391,1,0.0
hosts,0,0,1,0.007574867880211391,1,0.0
siberian,0,0,1,0.007574867880211391,1,0.0
sheep,0,0,1,0.007574867880211391,1,0.0
flavorless,1,0,0,-0.007751027598355844,1,0.0
shave,1,0,0,-0.007751027598355844,1,0.0
cone,1,0,0,-0.007751027598355844,1,0.0
slaloming,0,0,1,0.007574867880211391,1,0.0
flurries,0,0,1,0.007574867880211391,1,0.0
enthusiastic,0,0,1,0.007574867880211391,1,0.0
performanceskeep,0,0,1,0.007574867880211391,1,0.0
inconceivable,1,0,0,-0.007751027598355844,1,0.0
coma,0,0,1,0.007574867880211391,1,0.0
placing,0,0,1,0.007574867880211391,1,0.0
humiliated,1,0,0,-0.007751027598355844,1,0.0
parentswill,1,0,0,-0.007751027598355844,1,0.0
crappy,1,0,0,-0.007751027598355844,1,0.0
insults,1,0,0,-0.007751027598355844,1,0.0
digit,1,0,0,-0.007751027598355844,1,0.0
uncool,1,0,0,-0.007751027598355844,1,0.0
gadzooks,1,0,0,-0.007751027598355844,1,0.0
costs,1,0,1,-0.0001174398120963021,2,1.0
preschooler,1,0,0,-0.007751027598355844,1,0.0
buffoonery,1,0,0,-0.007751027598355844,1,0.0
tickle,1,0,0,-0.007751027598355844,1,0.0
bogus,2,0,1,-0.007809747504403995,3,1.5849625007211563
slowest,1,0,0,-0.007751027598355844,1,0.0
signal,1,0,0,-0.007751027598355844,1,0.0
lasts,1,0,0,-0.007751027598355844,1,0.0
iditarod,1,0,0,-0.007751027598355844,1,0.0
adventuresome,0,0,1,0.007574867880211391,1,0.0
ratchets,1,0,0,-0.007751027598355844,1,0.0
winks,1,0,0,-0.007751027598355844,1,0.0
doggie,1,0,0,-0.007751027598355844,1,0.0
perverse,1,0,0,-0.007751027598355844,1,0.0
poodle,1,0,0,-0.007751027598355844,1,0.0
blithely,1,0,0,-0.007751027598355844,1,0.0
levant,1,0,0,-0.007751027598355844,1,0.0
bows,1,0,0,-0.007751027598355844,1,0.0
skates,1,0,0,-0.007751027598355844,1,0.0
pausing,1,0,0,-0.007751027598355844,1,0.0
collie,0,0,1,0.007574867880211391,1,0.0
phoned,1,0,0,-0.007751027598355844,1,0.0
frontman,0,0,1,0.007574867880211391,1,0.0
ingratiating,1,0,0,-0.007751027598355844,1,0.0
laden,1,0,0,-0.007751027598355844,1,0.0
provoked,1,0,0,-0.007751027598355844,1,0.0
workings,0,0,1,0.007574867880211391,1,0.0
planets,0,0,1,0.007574867880211391,1,0.0
cameron,0,0,1,0.007574867880211391,1,0.0
titanic,0,0,1,0.007574867880211391,1,0.0
lighted,1,0,0,-0.007751027598355844,1,0.0
inquiries,1,0,0,-0.007751027598355844,1,0.0
redeemable,2,0,0,-0.015443335290663537,2,1.0
distill,0,0,1,0.007574867880211391,1,0.0
andrei,0,0,1,0.007574867880211391,1,0.0
tarkovsky,0,0,3,0.022842043452730474,3,1.5849625007211563
emotionless,0,0,1,0.007574867880211391,1,0.0
recapturing,0,0,2,0.015208455666470933,2,1.0
swirl,0,0,1,0.007574867880211391,1,0.0
murkiest,1,0,0,-0.007751027598355844,1,0.0
lately,0,0,1,0.007574867880211391,1,0.0
sleepwalking,0,0,1,0.007574867880211391,1,0.0
blustery,1,0,0,-0.007751027598355844,1,0.0
buffs,0,0,1,0.007574867880211391,1,0.0
gamble,0,0,1,0.007574867880211391,1,0.0
germinate,0,0,1,0.007574867880211391,1,0.0
brainy,2,0,0,-0.015443335290663537,2,1.0
suffocation,1,0,0,-0.007751027598355844,1,0.0
pieceso,1,0,0,-0.007751027598355844,1,0.0
snore,1,0,0,-0.007751027598355844,1,0.0
tagline,1,0,0,-0.007751027598355844,1,0.0
evasive,1,0,0,-0.007751027598355844,1,0.0
brockovich,1,0,0,-0.007751027598355844,1,0.0
concrete,0,0,1,0.007574867880211391,1,0.0
broader,0,0,2,0.015208455666470933,2,1.0
rapt,0,0,1,0.007574867880211391,1,0.0
experimentation,0,0,1,0.007574867880211391,1,0.0
opaque,1,0,0,-0.007751027598355844,1,0.0
patriarchal,0,0,1,0.007574867880211391,1,0.0
societies,0,0,1,0.007574867880211391,1,0.0
concentration,0,0,1,0.007574867880211391,1,0.0
prefer,0,0,3,0.022842043452730474,3,1.5849625007211563
debating,0,0,1,0.007574867880211391,1,0.0
brusqueness,1,0,0,-0.007751027598355844,1,0.0
italics,1,0,0,-0.007751027598355844,1,0.0
afterwards,0,0,1,0.007574867880211391,1,0.0
discuss,0,0,1,0.007574867880211391,1,0.0
stew,0,0,1,0.007574867880211391,1,0.0
skims,0,0,1,0.007574867880211391,1,0.0
yields,1,0,0,-0.007751027598355844,1,0.0
outer,1,0,1,-0.0001174398120963021,2,1.0
whiff,1,0,0,-0.007751027598355844,1,0.0
sterility,1,0,0,-0.007751027598355844,1,0.0
swing,1,0,0,-0.007751027598355844,1,0.0
liberally,1,0,0,-0.007751027598355844,1,0.0
associate,1,0,0,-0.007751027598355844,1,0.0
enchanted,1,0,0,-0.007751027598355844,1,0.0
seasoned,1,0,0,-0.007751027598355844,1,0.0
shapable,1,0,0,-0.007751027598355844,1,0.0
accessibility,1,0,0,-0.007751027598355844,1,0.0
burdened,1,0,0,-0.007751027598355844,1,0.0
hookers,0,0,1,0.007574867880211391,1,0.0
clients,0,0,2,0.015208455666470933,2,1.0
infrequently,1,0,0,-0.007751027598355844,1,0.0
lurid,1,0,0,-0.007751027598355844,1,0.0
combustible,0,0,1,0.007574867880211391,1,0.0
walled,0,0,1,0.007574867880211391,1,0.0
chewing,1,0,0,-0.007751027598355844,1,0.0
actorliness,1,0,0,-0.007751027598355844,1,0.0
indulgence,2,0,0,-0.015443335290663537,2,1.0
gnashing,1,0,0,-0.007751027598355844,1,0.0
schedule,1,0,0,-0.007751027598355844,1,0.0
aids,1,0,0,-0.007751027598355844,1,0.0
duration,1,0,0,-0.007751027598355844,1,0.0
carlen,1,0,0,-0.007751027598355844,1,0.0
ruffle,1,0,0,-0.007751027598355844,1,0.0
erratic,1,0,0,-0.007751027598355844,1,0.0
prostitute,0,0,1,0.007574867880211391,1,0.0
needy,0,0,1,0.007574867880211391,1,0.0
tentative,1,0,0,-0.007751027598355844,1,0.0
sulking,1,0,0,-0.007751027598355844,1,0.0
candidate,1,0,0,-0.007751027598355844,1,0.0
dynamited,1,0,0,-0.007751027598355844,1,0.0
routinely,1,0,0,-0.007751027598355844,1,0.0
foreshadowing,1,0,0,-0.007751027598355844,1,0.0
blethyn,1,0,0,-0.007751027598355844,1,0.0
stupidest,1,0,0,-0.007751027598355844,1,0.0
kok,0,0,1,0.007574867880211391,1,0.0
butthead,0,0,1,0.007574867880211391,1,0.0
beavis,0,0,1,0.007574867880211391,1,0.0
ample,0,0,1,0.007574867880211391,1,0.0
120,1,0,0,-0.007751027598355844,1,0.0
sat,1,0,0,-0.007751027598355844,1,0.0
jarvis,1,0,0,-0.007751027598355844,1,0.0
wally,2,0,0,-0.015443335290663537,2,1.0
wolodarsky,2,0,0,-0.015443335290663537,2,1.0
coolidge,1,0,0,-0.007751027598355844,1,0.0
expects,2,0,0,-0.015443335290663537,2,1.0
delta,1,0,0,-0.007751027598355844,1,0.0
beta,1,0,0,-0.007751027598355844,1,0.0
scenarios,1,0,0,-0.007751027598355844,1,0.0
saddled,1,0,0,-0.007751027598355844,1,0.0
rho,1,0,0,-0.007751027598355844,1,0.0
kappa,1,0,0,-0.007751027598355844,1,0.0
phi,1,0,0,-0.007751027598355844,1,0.0
coeducational,1,0,0,-0.007751027598355844,1,0.0
pride,1,0,1,-0.0001174398120963021,2,1.0
rosenbaum,1,0,0,-0.007751027598355844,1,0.0
harland,2,0,0,-0.015443335290663537,2,1.0
inject,1,0,2,0.0075161479741632405,3,1.5849625007211563
brainer,1,0,2,0.0075161479741632405,3,1.5849625007211563
reassignment,1,0,0,-0.007751027598355844,1,0.0
permanent,1,0,0,-0.007751027598355844,1,0.0
unrecommendable,1,0,0,-0.007751027598355844,1,0.0
stiletto,1,0,0,-0.007751027598355844,1,0.0
stomps,2,0,0,-0.015443335290663537,2,1.0
nerds,1,0,0,-0.007751027598355844,1,0.0
kegger,1,0,0,-0.007751027598355844,1,0.0
sounded,1,0,0,-0.007751027598355844,1,0.0
margaritas,1,0,0,-0.007751027598355844,1,0.0
packs,1,0,1,-0.0001174398120963021,2,1.0
pitcher,1,0,0,-0.007751027598355844,1,0.0
exam,1,0,0,-0.007751027598355844,1,0.0
entrance,1,0,0,-0.007751027598355844,1,0.0
wilder,1,0,0,-0.007751027598355844,1,0.0
projector,1,0,0,-0.007751027598355844,1,0.0
lens,1,0,0,-0.007751027598355844,1,0.0
masquerade,1,0,0,-0.007751027598355844,1,0.0
hypocritical,1,0,0,-0.007751027598355844,1,0.0
sexism,1,0,0,-0.007751027598355844,1,0.0
shower,1,0,0,-0.007751027598355844,1,0.0
shirt,1,0,0,-0.007751027598355844,1,0.0
clothing,1,0,0,-0.007751027598355844,1,0.0
deficiency,1,0,0,-0.007751027598355844,1,0.0
heels,1,0,1,-0.0001174398120963021,2,1.0
bowser,1,0,0,-0.007751027598355844,1,0.0
tosses,1,0,0,-0.007751027598355844,1,0.0
paeans,1,0,0,-0.007751027598355844,1,0.0
brutality,1,0,0,-0.007751027598355844,1,0.0
toys,1,0,0,-0.007751027598355844,1,0.0
raimi,0,0,4,0.03047563123899002,4,2.0
franchises,0,0,1,0.007574867880211391,1,0.0
fx,0,0,1,0.007574867880211391,1,0.0
anachronistically,0,0,1,0.007574867880211391,1,0.0
geek,0,0,1,0.007574867880211391,1,0.0
tobey,0,0,2,0.015208455666470933,2,1.0
overstating,0,0,1,0.007574867880211391,1,0.0
cent,1,0,0,-0.007751027598355844,1,0.0
fading,1,0,0,-0.007751027598355844,1,0.0
gum,1,0,0,-0.007751027598355844,1,0.0
matured,0,0,1,0.007574867880211391,1,0.0
toast,0,0,1,0.007574867880211391,1,0.0
carried,0,0,1,0.007574867880211391,1,0.0
trapeze,0,0,1,0.007574867880211391,1,0.0
inescapably,0,0,1,0.007574867880211391,1,0.0
xxi,0,0,1,0.007574867880211391,1,0.0
llegado,0,0,1,0.007574867880211391,1,0.0
necesita,0,0,1,0.007574867880211391,1,0.0
quedarse,0,0,1,0.007574867880211391,1,0.0
héroes,0,0,1,0.007574867880211391,1,0.0
haber,0,0,1,0.007574867880211391,1,0.0
parece,0,0,1,0.007574867880211391,1,0.0
hombre,0,0,1,0.007574867880211391,1,0.0
siglo,0,0,1,0.007574867880211391,1,0.0
araña,0,0,1,0.007574867880211391,1,0.0
spiderman,0,0,1,0.007574867880211391,1,0.0
rocks,0,0,1,0.007574867880211391,1,0.0
respects,0,0,1,0.007574867880211391,1,0.0
ensnared,0,0,1,0.007574867880211391,1,0.0
surroundings,0,0,1,0.007574867880211391,1,0.0
herring,0,0,1,0.007574867880211391,1,0.0
remove,0,0,1,0.007574867880211391,1,0.0
parental,0,0,1,0.007574867880211391,1,0.0
secretions,0,0,1,0.007574867880211391,1,0.0
hopefully,0,0,2,0.015208455666470933,2,1.0
novices,0,0,1,0.007574867880211391,1,0.0
insect,0,0,1,0.007574867880211391,1,0.0
arachnid,0,0,1,0.007574867880211391,1,0.0
longtime,0,0,1,0.007574867880211391,1,0.0
origin,1,0,0,-0.007751027598355844,1,0.0
becoes,0,0,1,0.007574867880211391,1,0.0
spiffy,1,0,2,0.0075161479741632405,3,1.5849625007211563
swinging,0,0,1,0.007574867880211391,1,0.0
unforced,0,0,2,0.015208455666470933,2,1.0
canny,0,0,1,0.007574867880211391,1,0.0
escapade,0,0,1,0.007574867880211391,1,0.0
augustinian,0,0,1,0.007574867880211391,1,0.0
neo,0,0,1,0.007574867880211391,1,0.0
broaches,0,0,1,0.007574867880211391,1,0.0
gates,0,0,1,0.007574867880211391,1,0.0
maturity,0,0,2,0.015208455666470933,2,1.0
elegance,0,0,2,0.015208455666470933,2,1.0
adorns,0,0,1,0.007574867880211391,1,0.0
rushed,2,0,0,-0.015443335290663537,2,1.0
2001,1,0,0,-0.007751027598355844,1,0.0
spry,1,0,0,-0.007751027598355844,1,0.0
4th,1,0,0,-0.007751027598355844,1,0.0
reserve,1,0,0,-0.007751027598355844,1,0.0
2is,0,0,1,0.007574867880211391,1,0.0
glance,0,0,2,0.015208455666470933,2,1.0
rodriguezwas,1,0,0,-0.007751027598355844,1,0.0
aleck,0,0,1,0.007574867880211391,1,0.0
brat,0,0,1,0.007574867880211391,1,0.0
overdue,0,0,1,0.007574867880211391,1,0.0
profiling,0,0,1,0.007574867880211391,1,0.0
surest,0,0,1,0.007574867880211391,1,0.0
boggling,0,0,1,0.007574867880211391,1,0.0
incomplete,1,0,0,-0.007751027598355844,1,0.0
continuation,0,0,1,0.007574867880211391,1,0.0
gizmos,0,0,1,0.007574867880211391,1,0.0
relevance,1,0,0,-0.007751027598355844,1,0.0
togetherness,1,0,0,-0.007751027598355844,1,0.0
inter,1,0,0,-0.007751027598355844,1,0.0
workplace,1,0,0,-0.007751027598355844,1,0.0
substantive,0,0,1,0.007574867880211391,1,0.0
appreciably,0,0,1,0.007574867880211391,1,0.0
charmingly,0,0,1,0.007574867880211391,1,0.0
bottle,0,0,1,0.007574867880211391,1,0.0
rocking,0,0,1,0.007574867880211391,1,0.0
vega,0,0,1,0.007574867880211391,1,0.0
anchor,0,0,1,0.007574867880211391,1,0.0
bickering,0,0,1,0.007574867880211391,1,0.0
byplay,0,0,1,0.007574867880211391,1,0.0
sabara,0,0,1,0.007574867880211391,1,0.0
blessedly,0,0,1,0.007574867880211391,1,0.0
britches,1,0,0,-0.007751027598355844,1,0.0
bloated,0,0,1,0.007574867880211391,1,0.0
resentment,0,0,1,0.007574867880211391,1,0.0
inflicted,0,0,1,0.007574867880211391,1,0.0
koury,0,0,3,0.022842043452730474,3,1.5849625007211563
retaliation,0,0,1,0.007574867880211391,1,0.0
perception,0,0,1,0.007574867880211391,1,0.0
hauntingit,0,0,1,0.007574867880211391,1,0.0
josh,0,0,1,0.007574867880211391,1,0.0
maladjusted,0,0,1,0.007574867880211391,1,0.0
narcotized,0,0,1,0.007574867880211391,1,0.0
expanded,1,0,0,-0.007751027598355844,1,0.0
unfinished,1,0,0,-0.007751027598355844,1,0.0
destructiveness,0,0,1,0.007574867880211391,1,0.0
accurately,2,0,1,-0.007809747504403995,3,1.5849625007211563
fuels,0,0,1,0.007574867880211391,1,0.0
yield,0,0,1,0.007574867880211391,1,0.0
determinedly,0,0,1,0.007574867880211391,1,0.0
nihilism,0,0,1,0.007574867880211391,1,0.0
unbridled,0,0,1,0.007574867880211391,1,0.0
yesterday,1,0,2,0.0075161479741632405,3,1.5849625007211563
tomorrow,0,0,2,0.015208455666470933,2,1.0
depleted,0,0,1,0.007574867880211391,1,0.0
unnoticed,0,0,1,0.007574867880211391,1,0.0
shedding,0,0,1,0.007574867880211391,1,0.0
underappreciated,0,0,1,0.007574867880211391,1,0.0
belated,0,0,1,0.007574867880211391,1,0.0
unsung,0,0,3,0.022842043452730474,3,1.5849625007211563
counted,0,0,1,0.007574867880211391,1,0.0
misgivings,0,0,1,0.007574867880211391,1,0.0
regardless,0,0,2,0.015208455666470933,2,1.0
biased,1,0,0,-0.007751027598355844,1,0.0
osborne,0,0,1,0.007574867880211391,1,0.0
montell,0,0,1,0.007574867880211391,1,0.0
joan,0,0,1,0.007574867880211391,1,0.0
grooves,0,0,1,0.007574867880211391,1,0.0
segments,0,0,1,0.007574867880211391,1,0.0
listen,0,0,3,0.022842043452730474,3,1.5849625007211563
irreplaceable,0,0,1,0.007574867880211391,1,0.0
enactments,0,0,1,0.007574867880211391,1,0.0
deliriously,0,0,1,0.007574867880211391,1,0.0
gaye,0,0,1,0.007574867880211391,1,0.0
supremes,0,0,1,0.007574867880211391,1,0.0
marvin,0,0,1,0.007574867880211391,1,0.0
rattled,0,0,1,0.007574867880211391,1,0.0
shook,0,0,1,0.007574867880211391,1,0.0
rolled,0,0,1,0.007574867880211391,1,0.0
contribution,0,0,1,0.007574867880211391,1,0.0
inestimable,0,0,1,0.007574867880211391,1,0.0
fore,0,0,1,0.007574867880211391,1,0.0
worm,0,0,1,0.007574867880211391,1,0.0
smokey,0,0,1,0.007574867880211391,1,0.0
underrecognized,0,0,1,0.007574867880211391,1,0.0
smashing,0,0,1,0.007574867880211391,1,0.0
waltz,0,0,1,0.007574867880211391,1,0.0
doubtful,0,0,1,0.007574867880211391,1,0.0
hardcore,0,0,1,0.007574867880211391,1,0.0
putty,1,0,0,-0.007751027598355844,1,0.0
prosthetic,1,0,0,-0.007751027598355844,1,0.0
costumes,2,0,0,-0.015443335290663537,2,1.0
thrift,1,0,0,-0.007751027598355844,1,0.0
trekkie,1,0,0,-0.007751027598355844,1,0.0
kmart,1,0,0,-0.007751027598355844,1,0.0
meekly,1,0,0,-0.007751027598355844,1,0.0
wince,1,0,0,-0.007751027598355844,1,0.0
voyages,1,0,0,-0.007751027598355844,1,0.0
dearly,1,0,0,-0.007751027598355844,1,0.0
limping,1,0,0,-0.007751027598355844,1,0.0
dilithium,0,0,1,0.007574867880211391,1,0.0
insurrection,0,0,2,0.015208455666470933,2,1.0
warp,0,0,1,0.007574867880211391,1,0.0
crystals,0,0,1,0.007574867880211391,1,0.0
containing,0,0,1,0.007574867880211391,1,0.0
nameless,1,0,0,-0.007751027598355844,1,0.0
climactic,1,0,0,-0.007751027598355844,1,0.0
shall,1,0,0,-0.007751027598355844,1,0.0
contriving,1,0,0,-0.007751027598355844,1,0.0
laser,1,0,0,-0.007751027598355844,1,0.0
uncommitted,1,0,0,-0.007751027598355844,1,0.0
devotees,0,0,1,0.007574867880211391,1,0.0
nagging,0,0,1,0.007574867880211391,1,0.0
vi,0,0,2,0.015208455666470933,2,1.0
treks,0,0,1,0.007574867880211391,1,0.0
faint,0,0,1,0.007574867880211391,1,0.0
undiscovered,0,0,1,0.007574867880211391,1,0.0
tenth,0,0,1,0.007574867880211391,1,0.0
krige,0,0,1,0.007574867880211391,1,0.0
parsec,0,0,1,0.007574867880211391,1,0.0
finishes,0,0,1,0.007574867880211391,1,0.0
borg,0,0,1,0.007574867880211391,1,0.0
cape,0,0,1,0.007574867880211391,1,0.0
pumped,0,0,1,0.007574867880211391,1,0.0
flimsier,1,0,0,-0.007751027598355844,1,0.0
logically,1,0,0,-0.007751027598355844,1,0.0
porous,1,0,0,-0.007751027598355844,1,0.0
baird,1,0,0,-0.007751027598355844,1,0.0
perils,0,0,1,0.007574867880211391,1,0.0
existentialism,1,0,0,-0.007751027598355844,1,0.0
reminding,1,0,0,-0.007751027598355844,1,0.0
pap,1,0,0,-0.007751027598355844,1,0.0
undergraduate,1,0,0,-0.007751027598355844,1,0.0
fifth,1,0,0,-0.007751027598355844,1,0.0
doubling,1,0,0,-0.007751027598355844,1,0.0
invested,1,0,0,-0.007751027598355844,1,0.0
wizard,1,0,0,-0.007751027598355844,1,0.0
subtexts,1,0,0,-0.007751027598355844,1,0.0
stabs,1,0,0,-0.007751027598355844,1,0.0
10th,1,0,0,-0.007751027598355844,1,0.0
65th,1,0,0,-0.007751027598355844,1,0.0
drink,1,0,2,0.0075161479741632405,3,1.5849625007211563
mixer,1,0,0,-0.007751027598355844,1,0.0
honored,1,0,0,-0.007751027598355844,1,0.0
hardware,0,0,1,0.007574867880211391,1,0.0
indulge,0,0,1,0.007574867880211391,1,0.0
midsection,1,0,0,-0.007751027598355844,1,0.0
paunchy,1,0,0,-0.007751027598355844,1,0.0
plodding,3,0,0,-0.02313564298297123,3,1.5849625007211563
undramatic,1,0,0,-0.007751027598355844,1,0.0
visionary,0,0,1,0.007574867880211391,1,0.0
dozens,0,0,1,0.007574867880211391,1,0.0
raving,1,0,0,-0.007751027598355844,1,0.0
lustrous,0,0,1,0.007574867880211391,1,0.0
heaped,1,0,0,-0.007751027598355844,1,0.0
mythological,0,0,1,0.007574867880211391,1,0.0
restoring,0,0,1,0.007574867880211391,1,0.0
establish,0,0,1,0.007574867880211391,1,0.0
deepening,0,0,1,0.007574867880211391,1,0.0
helped,0,0,1,0.007574867880211391,1,0.0
plots,1,0,0,-0.007751027598355844,1,0.0
recognizes,1,0,0,-0.007751027598355844,1,0.0
overinflated,1,0,0,-0.007751027598355844,1,0.0
obtaining,0,0,1,0.007574867880211391,1,0.0
lusting,0,0,1,0.007574867880211391,1,0.0
sencillamente,0,0,1,0.007574867880211391,1,0.0
sorprenderá,0,0,1,0.007574867880211391,1,0.0
visualmente,0,0,1,0.007574867880211391,1,0.0
entretenida,0,0,1,0.007574867880211391,1,0.0
muy,0,0,1,0.007574867880211391,1,0.0
espectacular,0,0,1,0.007574867880211391,1,0.0
te,0,0,1,0.007574867880211391,1,0.0
congeals,0,0,1,0.007574867880211391,1,0.0
wheezy,1,0,0,-0.007751027598355844,1,0.0
censure,1,0,0,-0.007751027598355844,1,0.0
damning,2,0,0,-0.015443335290663537,2,1.0
clumsiness,1,0,0,-0.007751027598355844,1,0.0
gonna,0,0,1,0.007574867880211391,1,0.0
hire,1,0,0,-0.007751027598355844,1,0.0
palette,0,0,1,0.007574867880211391,1,0.0
boffo,0,0,1,0.007574867880211391,1,0.0
dropping,0,0,1,0.007574867880211391,1,0.0
30s,1,0,0,-0.007751027598355844,1,0.0
40s,1,0,0,-0.007751027598355844,1,0.0
serials,1,0,0,-0.007751027598355844,1,0.0
uncover,0,0,1,0.007574867880211391,1,0.0
storied,0,0,1,0.007574867880211391,1,0.0
dug,1,0,0,-0.007751027598355844,1,0.0
45,0,0,1,0.007574867880211391,1,0.0
showmanship,0,0,1,0.007574867880211391,1,0.0
quivering,0,0,1,0.007574867880211391,1,0.0
yoda,0,0,1,0.007574867880211391,1,0.0
ascends,0,0,1,0.007574867880211391,1,0.0
computerized,0,0,1,0.007574867880211391,1,0.0
teeming,0,0,1,0.007574867880211391,1,0.0
technological,1,0,0,-0.007751027598355844,1,0.0
alllucas,1,0,0,-0.007751027598355844,1,0.0
producing,1,0,0,-0.007751027598355844,1,0.0
plummets,1,0,0,-0.007751027598355844,1,0.0
structuring,1,0,0,-0.007751027598355844,1,0.0
loudly,0,0,1,0.007574867880211391,1,0.0
rubbing,0,0,1,0.007574867880211391,1,0.0
chuckles,1,0,0,-0.007751027598355844,1,0.0
wreaked,1,0,0,-0.007751027598355844,1,0.0
compromised,1,0,0,-0.007751027598355844,1,0.0
lowering,1,0,0,-0.007751027598355844,1,0.0
mcculloch,2,0,0,-0.015443335290663537,2,1.0
permission,1,0,0,-0.007751027598355844,1,0.0
saddam,1,0,0,-0.007751027598355844,1,0.0
hussein,1,0,0,-0.007751027598355844,1,0.0
ramblings,1,0,0,-0.007751027598355844,1,0.0
soliloquies,1,0,0,-0.007751027598355844,1,0.0
smorgasbord,1,0,0,-0.007751027598355844,1,0.0
barrymore,1,0,0,-0.007751027598355844,1,0.0
dues,1,0,0,-0.007751027598355844,1,0.0
unread,1,0,0,-0.007751027598355844,1,0.0
induces,1,0,0,-0.007751027598355844,1,0.0
boorish,1,0,0,-0.007751027598355844,1,0.0
futility,1,0,0,-0.007751027598355844,1,0.0
zeus,1,0,0,-0.007751027598355844,1,0.0
snatch,1,0,0,-0.007751027598355844,1,0.0
equipment,1,0,0,-0.007751027598355844,1,0.0
aisle,1,0,0,-0.007751027598355844,1,0.0
beginnings,1,0,0,-0.007751027598355844,1,0.0
middles,1,0,0,-0.007751027598355844,1,0.0
molested,1,0,0,-0.007751027598355844,1,0.0
freddie,1,0,0,-0.007751027598355844,1,0.0
fingered,1,0,1,-0.0001174398120963021,2,1.0
nicest,1,0,0,-0.007751027598355844,1,0.0
freddy,1,0,0,-0.007751027598355844,1,0.0
noises,1,0,0,-0.007751027598355844,1,0.0
underarm,1,0,0,-0.007751027598355844,1,0.0
marquee,1,0,0,-0.007751027598355844,1,0.0
unschooled,1,0,0,-0.007751027598355844,1,0.0
ivy,1,0,0,-0.007751027598355844,1,0.0
larceny,1,0,0,-0.007751027598355844,1,0.0
theft,1,0,0,-0.007751027598355844,1,0.0
limp,1,0,0,-0.007751027598355844,1,0.0
meander,1,0,0,-0.007751027598355844,1,0.0
unrecoverable,1,0,0,-0.007751027598355844,1,0.0
suckers,1,0,0,-0.007751027598355844,1,0.0
creeps,1,0,0,-0.007751027598355844,1,0.0
surrender,1,0,0,-0.007751027598355844,1,0.0
revolution,1,0,1,-0.0001174398120963021,2,1.0
masochistic,1,0,0,-0.007751027598355844,1,0.0
depressingly,1,0,0,-0.007751027598355844,1,0.0
exhaustingly,1,0,0,-0.007751027598355844,1,0.0
wallet,1,0,0,-0.007751027598355844,1,0.0
repetitious,1,0,0,-0.007751027598355844,1,0.0
recompense,1,0,0,-0.007751027598355844,1,0.0
ski,1,0,0,-0.007751027598355844,1,0.0
snowball,0,0,1,0.007574867880211391,1,0.0
rubin,0,0,1,0.007574867880211391,1,0.0
updating,0,0,1,0.007574867880211391,1,0.0
minkoff,0,0,1,0.007574867880211391,1,0.0
puff,0,0,1,0.007574867880211391,1,0.0
pollyana,1,0,0,-0.007751027598355844,1,0.0
equals,0,0,1,0.007574867880211391,1,0.0
betters,0,0,1,0.007574867880211391,1,0.0
accomplish,0,0,1,0.007574867880211391,1,0.0
accomplishments,0,0,2,0.015208455666470933,2,1.0
maintained,0,0,1,0.007574867880211391,1,0.0
whimsicalthe,0,0,1,0.007574867880211391,1,0.0
bedtime,0,0,1,0.007574867880211391,1,0.0
oversized,0,0,1,0.007574867880211391,1,0.0
grandkids,0,0,1,0.007574867880211391,1,0.0
grandparents,0,0,1,0.007574867880211391,1,0.0
sl2,0,0,1,0.007574867880211391,1,0.0
72,1,0,0,-0.007751027598355844,1,0.0
cryin,2,0,0,-0.015443335290663537,2,1.0
relate,1,0,0,-0.007751027598355844,1,0.0
despondent,1,0,0,-0.007751027598355844,1,0.0
achilles,1,0,0,-0.007751027598355844,1,0.0
heel,1,0,0,-0.007751027598355844,1,0.0
heightened,1,0,0,-0.007751027598355844,1,0.0
borrow,0,0,1,0.007574867880211391,1,0.0
rekindle,1,0,0,-0.007751027598355844,1,0.0
digits,1,0,0,-0.007751027598355844,1,0.0
expressive,0,0,1,0.007574867880211391,1,0.0
cuteness,0,0,1,0.007574867880211391,1,0.0
margolo,0,0,1,0.007574867880211391,1,0.0
cheeky,0,0,2,0.015208455666470933,2,1.0
cuddly,0,0,1,0.007574867880211391,1,0.0
delicately,0,0,1,0.007574867880211391,1,0.0
calibrated,0,0,1,0.007574867880211391,1,0.0
stickiness,0,0,1,0.007574867880211391,1,0.0
golden,0,0,1,0.007574867880211391,1,0.0
sprung,0,0,1,0.007574867880211391,1,0.0
stealer,0,0,1,0.007574867880211391,1,0.0
unavoidably,0,0,1,0.007574867880211391,1,0.0
divert,0,0,1,0.007574867880211391,1,0.0
attendance,0,0,1,0.007574867880211391,1,0.0
immaculate,1,0,0,-0.007751027598355844,1,0.0
78,0,0,1,0.007574867880211391,1,0.0
felicities,0,0,1,0.007574867880211391,1,0.0
vacillating,0,0,1,0.007574867880211391,1,0.0
rant,1,0,0,-0.007751027598355844,1,0.0
columnist,1,0,0,-0.007751027598355844,1,0.0
architecture,1,0,0,-0.007751027598355844,1,0.0
sayles,1,0,10,0.06858485026423958,11,3.4594316186372978
leisurely,0,0,1,0.007574867880211391,1,0.0
explored,0,0,1,0.007574867880211391,1,0.0
insufficiently,0,0,1,0.007574867880211391,1,0.0
ethnicities,0,0,1,0.007574867880211391,1,0.0
sunshine,2,0,5,0.022724603640634174,7,2.807354922057604
resurrecting,0,0,1,0.007574867880211391,1,0.0
flavorful,0,0,1,0.007574867880211391,1,0.0
edie,0,0,1,0.007574867880211391,1,0.0
falco,0,0,1,0.007574867880211391,1,0.0
dissipated,1,0,0,-0.007751027598355844,1,0.0
addresses,0,0,2,0.015208455666470933,2,1.0
interwoven,0,0,1,0.007574867880211391,1,0.0
intermingling,0,0,1,0.007574867880211391,1,0.0
preciously,0,0,1,0.007574867880211391,1,0.0
inner,0,0,2,0.015208455666470933,2,1.0
indelible,0,0,1,0.007574867880211391,1,0.0
wordplay,0,0,1,0.007574867880211391,1,0.0
pageants,0,0,1,0.007574867880211391,1,0.0
neglecting,0,0,1,0.007574867880211391,1,0.0
tourism,0,0,1,0.007574867880211391,1,0.0
acute,0,0,1,0.007574867880211391,1,0.0
mundanity,0,0,1,0.007574867880211391,1,0.0
smallish,0,0,1,0.007574867880211391,1,0.0
purposefully,0,0,1,0.007574867880211391,1,0.0
balls,0,0,1,0.007574867880211391,1,0.0
altman,0,0,2,0.015208455666470933,2,1.0
enticing,0,0,1,0.007574867880211391,1,0.0
dénouement,0,0,1,0.007574867880211391,1,0.0
auteur,0,0,1,0.007574867880211391,1,0.0
globalizing,0,0,1,0.007574867880211391,1,0.0
plaguing,0,0,1,0.007574867880211391,1,0.0
sodden,1,0,0,-0.007751027598355844,1,0.0
sum,0,0,1,0.007574867880211391,1,0.0
moviemakers,0,0,1,0.007574867880211391,1,0.0
uniformly,0,0,1,0.007574867880211391,1,0.0
forcefully,1,0,1,-0.0001174398120963021,2,1.0
agenda,0,0,1,0.007574867880211391,1,0.0
concern,0,0,1,0.007574867880211391,1,0.0
ignites,0,0,1,0.007574867880211391,1,0.0
becalmed,1,0,0,-0.007751027598355844,1,0.0
cloudy,1,0,0,-0.007751027598355844,1,0.0
assesses,1,0,0,-0.007751027598355844,1,0.0
swap,1,0,0,-0.007751027598355844,1,0.0
relatives,2,0,0,-0.015443335290663537,2,1.0
depart,1,0,0,-0.007751027598355844,1,0.0
weighs,2,0,0,-0.015443335290663537,2,1.0
champagne,1,0,0,-0.007751027598355844,1,0.0
responsável,1,0,0,-0.007751027598355844,1,0.0
aproveitar,1,0,0,-0.007751027598355844,1,0.0
escapa,1,0,0,-0.007751027598355844,1,0.0
consegue,1,0,0,-0.007751027598355844,1,0.0
cox,1,0,0,-0.007751027598355844,1,0.0
mediocridade,1,0,0,-0.007751027598355844,1,0.0
doce,1,0,0,-0.007751027598355844,1,0.0
direto,1,0,0,-0.007751027598355844,1,0.0
fracasso,1,0,0,-0.007751027598355844,1,0.0
lar,1,0,0,-0.007751027598355844,1,0.0
artístico,1,0,0,-0.007751027598355844,1,0.0
sequer,1,0,0,-0.007751027598355844,1,0.0
pouquíssimos,1,0,0,-0.007751027598355844,1,0.0
laughsa,1,0,0,-0.007751027598355844,1,0.0
accumulated,1,0,0,-0.007751027598355844,1,0.0
miscalculation,1,0,0,-0.007751027598355844,1,0.0
fumbles,1,0,0,-0.007751027598355844,1,0.0
witherspoon,4,0,4,-0.00029359953024075264,8,3.0
forehead,0,0,1,0.007574867880211391,1,0.0
mason,1,0,0,-0.007751027598355844,1,0.0
extended,2,0,0,-0.015443335290663537,2,1.0
hamfisted,1,0,0,-0.007751027598355844,1,0.0
dixon,1,0,0,-0.007751027598355844,1,0.0
facilitator,1,0,0,-0.007751027598355844,1,0.0
slugs,1,0,0,-0.007751027598355844,1,0.0
advertised,0,0,2,0.015208455666470933,2,1.0
twang,1,0,0,-0.007751027598355844,1,0.0
avoided,2,0,0,-0.015443335290663537,2,1.0
texan,1,0,0,-0.007751027598355844,1,0.0
wasting,1,0,0,-0.007751027598355844,1,0.0
densest,1,0,0,-0.007751027598355844,1,0.0
distillation,1,0,0,-0.007751027598355844,1,0.0
bummer,1,0,0,-0.007751027598355844,1,0.0
kingdom,1,0,0,-0.007751027598355844,1,0.0
virulently,1,0,0,-0.007751027598355844,1,0.0
winsome,1,0,0,-0.007751027598355844,1,0.0
symmetry,1,0,0,-0.007751027598355844,1,0.0
vim,1,0,0,-0.007751027598355844,1,0.0
dialed,1,0,0,-0.007751027598355844,1,0.0
yorker,0,0,1,0.007574867880211391,1,0.0
infusion,0,0,1,0.007574867880211391,1,0.0
provincial,0,0,1,0.007574867880211391,1,0.0
unendurable,0,0,1,0.007574867880211391,1,0.0
foxworthy,0,0,1,0.007574867880211391,1,0.0
tolerate,0,0,1,0.007574867880211391,1,0.0
trades,0,0,1,0.007574867880211391,1,0.0
blueblood,0,0,1,0.007574867880211391,1,0.0
primarily,0,0,1,0.007574867880211391,1,0.0
perkiness,0,0,1,0.007574867880211391,1,0.0
slowness,0,0,1,0.007574867880211391,1,0.0
swept,5,0,0,-0.038520258367586616,5,2.321928094887362
bolero,1,0,0,-0.007751027598355844,1,0.0
eroti,1,0,0,-0.007751027598355844,1,0.0
bo,1,0,0,-0.007751027598355844,1,0.0
wertmuller,3,0,0,-0.02313564298297123,3,1.5849625007211563
lina,1,0,0,-0.007751027598355844,1,0.0
whatsoever,2,0,0,-0.015443335290663537,2,1.0
helluva,1,0,0,-0.007751027598355844,1,0.0
jargon,1,0,0,-0.007751027598355844,1,0.0
athleticism,1,0,0,-0.007751027598355844,1,0.0
sag,1,0,0,-0.007751027598355844,1,0.0
foundering,1,0,0,-0.007751027598355844,1,0.0
scum,1,0,0,-0.007751027598355844,1,0.0
glazed,1,0,0,-0.007751027598355844,1,0.0
festers,1,0,0,-0.007751027598355844,1,0.0
monkeys,1,0,0,-0.007751027598355844,1,0.0
flinging,1,0,0,-0.007751027598355844,1,0.0
dungpile,1,0,0,-0.007751027598355844,1,0.0
feces,1,0,1,-0.0001174398120963021,2,1.0
lagoon,1,0,0,-0.007751027598355844,1,0.0
abel,1,0,0,-0.007751027598355844,1,0.0
ferrara,1,0,0,-0.007751027598355844,1,0.0
begging,1,0,0,-0.007751027598355844,1,0.0
majorly,1,0,0,-0.007751027598355844,1,0.0
manifestos,1,0,0,-0.007751027598355844,1,0.0
inkling,1,0,0,-0.007751027598355844,1,0.0
elemental,1,0,0,-0.007751027598355844,1,0.0
literacy,1,0,0,-0.007751027598355844,1,0.0
defeatingly,1,0,0,-0.007751027598355844,1,0.0
decorous,1,0,0,-0.007751027598355844,1,0.0
deserving,1,0,0,-0.007751027598355844,1,0.0
backlash,1,0,0,-0.007751027598355844,1,0.0
describing,1,0,0,-0.007751027598355844,1,0.0
blinding,1,0,0,-0.007751027598355844,1,0.0
ordered,1,0,0,-0.007751027598355844,1,0.0
judy,1,0,0,-0.007751027598355844,1,0.0
saps,1,0,0,-0.007751027598355844,1,0.0
trumpets,0,0,1,0.007574867880211391,1,0.0
gesturing,1,0,0,-0.007751027598355844,1,0.0
muse,1,0,0,-0.007751027598355844,1,0.0
eludes,1,0,0,-0.007751027598355844,1,0.0
charmless,2,0,0,-0.015443335290663537,2,1.0
histrionic,1,0,0,-0.007751027598355844,1,0.0
disguising,0,0,1,0.007574867880211391,1,0.0
giles,0,0,1,0.007574867880211391,1,0.0
polson,0,0,2,0.015208455666470933,2,1.0
nuttgens,0,0,1,0.007574867880211391,1,0.0
adroitly,0,0,1,0.007574867880211391,1,0.0
jazzes,0,0,1,0.007574867880211391,1,0.0
spirals,1,0,0,-0.007751027598355844,1,0.0
thuds,1,0,0,-0.007751027598355844,1,0.0
recommended,0,0,1,0.007574867880211391,1,0.0
reviewed,0,0,1,0.007574867880211391,1,0.0
ageand,0,0,1,0.007574867880211391,1,0.0
drowning,1,0,0,-0.007751027598355844,1,0.0
frights,0,0,1,0.007574867880211391,1,0.0
seta,1,0,0,-0.007751027598355844,1,0.0
wastes,1,0,0,-0.007751027598355844,1,0.0
teeny,1,0,0,-0.007751027598355844,1,0.0
bopper,1,0,0,-0.007751027598355844,1,0.0
mimic,1,0,0,-0.007751027598355844,1,0.0
admittedly,1,0,0,-0.007751027598355844,1,0.0
swimfan,7,0,0,-0.053904873752202,7,2.807354922057604
deadening,1,0,0,-0.007751027598355844,1,0.0
olympic,1,0,1,-0.0001174398120963021,2,1.0
rehashes,1,0,0,-0.007751027598355844,1,0.0
shamu,1,0,0,-0.007751027598355844,1,0.0
unleashed,0,0,1,0.007574867880211391,1,0.0
crazed,0,0,1,0.007574867880211391,1,0.0
temptations,0,0,1,0.007574867880211391,1,0.0
1987,1,0,0,-0.007751027598355844,1,0.0
remade,1,0,0,-0.007751027598355844,1,0.0
smell,1,0,0,-0.007751027598355844,1,0.0
abrupt,1,0,0,-0.007751027598355844,1,0.0
discouraging,1,0,0,-0.007751027598355844,1,0.0
suspenserbut,1,0,0,-0.007751027598355844,1,0.0
rationale,1,0,0,-0.007751027598355844,1,0.0
squashed,1,0,0,-0.007751027598355844,1,0.0
preferably,1,0,0,-0.007751027598355844,1,0.0
mailing,1,0,0,-0.007751027598355844,1,0.0
frothing,0,0,1,0.007574867880211391,1,0.0
domino,0,0,1,0.007574867880211391,1,0.0
hiss,1,0,0,-0.007751027598355844,1,0.0
forgot,1,0,0,-0.007751027598355844,1,0.0
rejigger,1,0,0,-0.007751027598355844,1,0.0
denouement,1,0,0,-0.007751027598355844,1,0.0
loony,1,0,0,-0.007751027598355844,1,0.0
swimming,1,0,0,-0.007751027598355844,1,0.0
sleekly,1,0,0,-0.007751027598355844,1,0.0
weather,1,0,0,-0.007751027598355844,1,0.0
villainess,1,0,0,-0.007751027598355844,1,0.0
fifty,1,0,0,-0.007751027598355844,1,0.0
followed,1,0,0,-0.007751027598355844,1,0.0
melodramatics,1,0,0,-0.007751027598355844,1,0.0
inflated,1,0,0,-0.007751027598355844,1,0.0
seduces,1,0,0,-0.007751027598355844,1,0.0
neuwirth,1,0,1,-0.0001174398120963021,2,1.0
bebe,1,0,0,-0.007751027598355844,1,0.0
intelligentsia,1,0,0,-0.007751027598355844,1,0.0
founders,2,0,0,-0.015443335290663537,2,1.0
weaver,0,0,1,0.007574867880211391,1,0.0
77,0,0,2,0.015208455666470933,2,1.0
discontented,0,0,1,0.007574867880211391,1,0.0
tadpole,3,0,6,0.022665883734586022,9,3.1699250014423126
maude,0,0,1,0.007574867880211391,1,0.0
buzz,0,0,1,0.007574867880211391,1,0.0
utah,0,0,1,0.007574867880211391,1,0.0
declared,0,0,1,0.007574867880211391,1,0.0
festival,0,0,1,0.007574867880211391,1,0.0
descend,0,0,1,0.007574867880211391,1,0.0
ferret,0,0,1,0.007574867880211391,1,0.0
literate,0,0,1,0.007574867880211391,1,0.0
arean,0,0,1,0.007574867880211391,1,0.0
devilishly,0,0,1,0.007574867880211391,1,0.0
niels,0,0,1,0.007574867880211391,1,0.0
mcgowan,0,0,1,0.007574867880211391,1,0.0
mueller,0,0,1,0.007574867880211391,1,0.0
hackles,0,0,1,0.007574867880211391,1,0.0
recyclable,0,0,1,0.007574867880211391,1,0.0
switches,0,0,2,0.015208455666470933,2,1.0
smeary,1,0,0,-0.007751027598355844,1,0.0
preciousness,1,0,0,-0.007751027598355844,1,0.0
squanders,2,0,0,-0.015443335290663537,2,1.0
raconteur,0,0,1,0.007574867880211391,1,0.0
aesthete,0,0,1,0.007574867880211391,1,0.0
giddiness,0,0,1,0.007574867880211391,1,0.0
emblematic,1,0,0,-0.007751027598355844,1,0.0
ageism,1,0,0,-0.007751027598355844,1,0.0
afflicting,1,0,0,-0.007751027598355844,1,0.0
stepmom,0,0,1,0.007574867880211391,1,0.0
wispy,0,0,1,0.007574867880211391,1,0.0
cosmopolitan,0,0,1,0.007574867880211391,1,0.0
sparkling,1,0,1,-0.0001174398120963021,2,1.0
sacred,0,0,2,0.015208455666470933,2,1.0
cows,0,0,1,0.007574867880211391,1,0.0
stake,1,0,0,-0.007751027598355844,1,0.0
inexpensively,0,0,1,0.007574867880211391,1,0.0
frankness,0,0,1,0.007574867880211391,1,0.0
civility,0,0,1,0.007574867880211391,1,0.0
disgusted,0,0,1,0.007574867880211391,1,0.0
stubbornly,1,0,0,-0.007751027598355844,1,0.0
transgressive,1,0,0,-0.007751027598355844,1,0.0
artsploitation,1,0,0,-0.007751027598355844,1,0.0
enthusiast,1,0,0,-0.007751027598355844,1,0.0
universally,1,0,0,-0.007751027598355844,1,0.0
chainsaw,1,0,0,-0.007751027598355844,1,0.0
accounting,1,0,0,-0.007751027598355844,1,0.0
gripped,0,0,1,0.007574867880211391,1,0.0
wrongness,0,0,1,0.007574867880211391,1,0.0
justification,1,0,0,-0.007751027598355844,1,0.0
disturbingly,1,0,0,-0.007751027598355844,1,0.0
sophistication,1,0,0,-0.007751027598355844,1,0.0
bearable,1,0,0,-0.007751027598355844,1,0.0
mine,1,0,0,-0.007751027598355844,1,0.0
fringe,1,0,0,-0.007751027598355844,1,0.0
conspiracy,1,0,0,-0.007751027598355844,1,0.0
karen,1,0,0,-0.007751027598355844,1,0.0
theorist,1,0,0,-0.007751027598355844,1,0.0
weirder,0,0,1,0.007574867880211391,1,0.0
peers,0,0,1,0.007574867880211391,1,0.0
leeson,0,0,1,0.007574867880211391,1,0.0
emulate,0,0,1,0.007574867880211391,1,0.0
endorses,1,0,0,-0.007751027598355844,1,0.0
craven,3,0,0,-0.02313564298297123,3,1.5849625007211563
restore,1,0,0,-0.007751027598355844,1,0.0
praiseworthy,1,0,0,-0.007751027598355844,1,0.0
harmon,1,0,3,0.015149735760422781,4,2.0
terrors,1,0,0,-0.007751027598355844,1,0.0
rooting,1,0,0,-0.007751027598355844,1,0.0
crawlies,0,0,1,0.007574867880211391,1,0.0
unwary,0,0,1,0.007574867880211391,1,0.0
cheesiest,1,0,0,-0.007751027598355844,1,0.0
induce,1,0,0,-0.007751027598355844,1,0.0
fright,1,0,1,-0.0001174398120963021,2,1.0
crawly,1,0,0,-0.007751027598355844,1,0.0
stalked,1,0,0,-0.007751027598355844,1,0.0
gloom,1,0,0,-0.007751027598355844,1,0.0
burlap,1,0,0,-0.007751027598355844,1,0.0
murderers,0,0,1,0.007574867880211391,1,0.0
dastardly,0,0,1,0.007574867880211391,1,0.0
gothic,0,0,1,0.007574867880211391,1,0.0
sites,0,0,2,0.015208455666470933,2,1.0
videotapes,0,0,1,0.007574867880211391,1,0.0
apprehension,1,0,0,-0.007751027598355844,1,0.0
wella,0,0,1,0.007574867880211391,1,0.0
frighten,0,0,1,0.007574867880211391,1,0.0
spectacularly,0,0,2,0.015208455666470933,2,1.0
disturb,0,0,1,0.007574867880211391,1,0.0
wes,1,0,0,-0.007751027598355844,1,0.0
elm,1,0,0,-0.007751027598355844,1,0.0
scattershot,0,0,1,0.007574867880211391,1,0.0
terrorizing,0,0,1,0.007574867880211391,1,0.0
tact,0,0,1,0.007574867880211391,1,0.0
reviewers,1,0,0,-0.007751027598355844,1,0.0
reviews,1,0,0,-0.007751027598355844,1,0.0
unnamed,1,0,0,-0.007751027598355844,1,0.0
hushed,1,0,0,-0.007751027598355844,1,0.0
substitutable,1,0,0,-0.007751027598355844,1,0.0
creepier,0,0,1,0.007574867880211391,1,0.0
explicit,0,0,1,0.007574867880211391,1,0.0
unseen,0,0,1,0.007574867880211391,1,0.0
suitably,0,0,1,0.007574867880211391,1,0.0
exasperating,1,0,0,-0.007751027598355844,1,0.0
competently,1,0,0,-0.007751027598355844,1,0.0
nadir,1,0,0,-0.007751027598355844,1,0.0
horrified,1,0,0,-0.007751027598355844,1,0.0
snooze,1,0,0,-0.007751027598355844,1,0.0
cintas,1,0,0,-0.007751027598355844,1,0.0
talento,1,0,0,-0.007751027598355844,1,0.0
tan,1,0,0,-0.007751027598355844,1,0.0
escondido,1,0,0,-0.007751027598355844,1,0.0
verdad,1,0,0,-0.007751027598355844,1,0.0
desde,1,0,0,-0.007751027598355844,1,0.0
algún,1,0,0,-0.007751027598355844,1,0.0
esté,1,0,0,-0.007751027598355844,1,0.0
quién,1,0,0,-0.007751027598355844,1,0.0
dónde,1,0,0,-0.007751027598355844,1,0.0
mandoki,1,0,0,-0.007751027598355844,1,0.0
tiene,2,0,0,-0.015443335290663537,2,1.0
malas,1,0,0,-0.007751027598355844,1,0.0
pues,1,0,0,-0.007751027598355844,1,0.0
realizando,1,0,0,-0.007751027598355844,1,0.0
sabe,1,0,0,-0.007751027598355844,1,0.0
kidnappings,1,0,0,-0.007751027598355844,1,0.0
jokers,1,0,0,-0.007751027598355844,1,0.0
stinker,1,0,0,-0.007751027598355844,1,0.0
fireballs,1,0,0,-0.007751027598355844,1,0.0
sleepless,0,0,1,0.007574867880211391,1,0.0
effectiveness,0,0,1,0.007574867880211391,1,0.0
remotely,3,0,0,-0.02313564298297123,3,1.5849625007211563
idiots,1,0,0,-0.007751027598355844,1,0.0
printed,1,0,0,-0.007751027598355844,1,0.0
iles,1,0,0,-0.007751027598355844,1,0.0
substituting,1,0,0,-0.007751027598355844,1,0.0
phones,1,0,0,-0.007751027598355844,1,0.0
charlize,1,0,0,-0.007751027598355844,1,0.0
courtney,1,0,0,-0.007751027598355844,1,0.0
distressing,1,0,0,-0.007751027598355844,1,0.0
manqué,1,0,0,-0.007751027598355844,1,0.0
dès,1,0,0,-0.007751027598355844,1,0.0
les,1,0,0,-0.007751027598355844,1,0.0
qui,1,0,0,-0.007751027598355844,1,0.0
première,1,0,0,-0.007751027598355844,1,0.0
presque,1,0,0,-0.007751027598355844,1,0.0
sur,1,0,0,-0.007751027598355844,1,0.0
nerfs,1,0,0,-0.007751027598355844,1,0.0
tombe,1,0,0,-0.007751027598355844,1,0.0
murdock,1,0,0,-0.007751027598355844,1,0.0
ba,1,0,0,-0.007751027598355844,1,0.0
location,1,0,0,-0.007751027598355844,1,0.0
theron,1,0,0,-0.007751027598355844,1,0.0
borderline,1,0,0,-0.007751027598355844,1,0.0
deteriorates,1,0,0,-0.007751027598355844,1,0.0
bacon,2,0,0,-0.015443335290663537,2,1.0
protracted,1,0,0,-0.007751027598355844,1,0.0
captive,1,0,0,-0.007751027598355844,1,0.0
description,2,0,0,-0.015443335290663537,2,1.0
splashes,1,0,0,-0.007751027598355844,1,0.0
strings,1,0,0,-0.007751027598355844,1,0.0
subjecting,1,0,0,-0.007751027598355844,1,0.0
mechanism,1,0,0,-0.007751027598355844,1,0.0
slumming,1,0,0,-0.007751027598355844,1,0.0
indifferently,1,0,0,-0.007751027598355844,1,0.0
programmer,1,0,1,-0.0001174398120963021,2,1.0
negligible,1,0,0,-0.007751027598355844,1,0.0
doomsday,1,0,0,-0.007751027598355844,1,0.0
propulsive,0,0,1,0.007574867880211391,1,0.0
backstory,0,0,1,0.007574867880211391,1,0.0
creatively,0,0,1,0.007574867880211391,1,0.0
mistaking,1,0,1,-0.0001174398120963021,2,1.0
1934,2,0,0,-0.015443335290663537,2,1.0
lilo,0,0,1,0.007574867880211391,1,0.0
spades,0,0,1,0.007574867880211391,1,0.0
unruly,0,0,1,0.007574867880211391,1,0.0
denlopp,0,0,1,0.007574867880211391,1,0.0
fluent,0,0,1,0.007574867880211391,1,0.0
flatula,0,0,1,0.007574867880211391,1,0.0
advises,0,0,1,0.007574867880211391,1,0.0
updatings,0,0,1,0.007574867880211391,1,0.0
mimics,0,0,1,0.007574867880211391,1,0.0
morph,0,0,1,0.007574867880211391,1,0.0
deckhand,0,0,1,0.007574867880211391,1,0.0
parrot,0,0,1,0.007574867880211391,1,0.0
mateys,0,0,1,0.007574867880211391,1,0.0
fertility,0,0,1,0.007574867880211391,1,0.0
rivals,0,0,1,0.007574867880211391,1,0.0
animations,0,0,1,0.007574867880211391,1,0.0
fied,1,0,1,-0.0001174398120963021,2,1.0
cosmic,0,0,1,0.007574867880211391,1,0.0
biennial,0,0,2,0.015208455666470933,2,1.0
narcotizing,0,0,1,0.007574867880211391,1,0.0
reimagine,1,0,0,-0.007751027598355844,1,0.0
sidekicks,1,0,0,-0.007751027598355844,1,0.0
plasma,0,0,1,0.007574867880211391,1,0.0
conduits,0,0,1,0.007574867880211391,1,0.0
swashbuckling,0,0,1,0.007574867880211391,1,0.0
monday,0,0,1,0.007574867880211391,1,0.0
desecrations,0,0,1,0.007574867880211391,1,0.0
aladdin,0,0,1,0.007574867880211391,1,0.0
musker,1,0,0,-0.007751027598355844,1,0.0
retina,1,0,0,-0.007751027598355844,1,0.0
clements,1,0,0,-0.007751027598355844,1,0.0
vacuum,1,0,0,-0.007751027598355844,1,0.0
enthrall,0,0,1,0.007574867880211391,1,0.0
immortals,1,0,0,-0.007751027598355844,1,0.0
capricious,1,0,0,-0.007751027598355844,1,0.0
russell,2,0,0,-0.015443335290663537,2,1.0
overwhelmingly,0,0,1,0.007574867880211391,1,0.0
screentuck,0,0,1,0.007574867880211391,1,0.0
eternity,0,0,1,0.007574867880211391,1,0.0
hefty,0,0,1,0.007574867880211391,1,0.0
richness,0,0,1,0.007574867880211391,1,0.0
bygone,1,0,0,-0.007751027598355844,1,0.0
stream,0,0,1,0.007574867880211391,1,0.0
woodland,0,0,1,0.007574867880211391,1,0.0
syrup,1,0,0,-0.007751027598355844,1,0.0
conundrum,1,0,0,-0.007751027598355844,1,0.0
argument,0,0,1,0.007574867880211391,1,0.0
highlander,1,0,0,-0.007751027598355844,1,0.0
lolita,2,0,0,-0.015443335290663537,2,1.0
castrated,1,0,0,-0.007751027598355844,1,0.0
charitable,1,0,0,-0.007751027598355844,1,0.0
advantages,0,0,1,0.007574867880211391,1,0.0
bledel,1,0,0,-0.007751027598355844,1,0.0
destiny,0,0,1,0.007574867880211391,1,0.0
comforted,0,0,1,0.007574867880211391,1,0.0
boots,1,0,0,-0.007751027598355844,1,0.0
hobnail,1,0,0,-0.007751027598355844,1,0.0
babbitt,1,0,0,-0.007751027598355844,1,0.0
occasion,0,0,1,0.007574867880211391,1,0.0
unearthed,0,0,1,0.007574867880211391,1,0.0
flotsam,0,0,1,0.007574867880211391,1,0.0
savored,0,0,1,0.007574867880211391,1,0.0
plod,1,0,0,-0.007751027598355844,1,0.0
impressed,1,0,0,-0.007751027598355844,1,0.0
laconic,1,0,0,-0.007751027598355844,1,0.0
harks,0,0,1,0.007574867880211391,1,0.0
weighty,1,0,0,-0.007751027598355844,1,0.0
nonthreatening,0,0,1,0.007574867880211391,1,0.0
katherine,1,0,0,-0.007751027598355844,1,0.0
automated,1,0,0,-0.007751027598355844,1,0.0
newly,1,0,0,-0.007751027598355844,1,0.0
auditorium,1,0,0,-0.007751027598355844,1,0.0
somebodies,0,0,1,0.007574867880211391,1,0.0
proclaim,0,0,1,0.007574867880211391,1,0.0
according,1,0,0,-0.007751027598355844,1,0.0
evening,0,0,1,0.007574867880211391,1,0.0
guiltless,0,0,1,0.007574867880211391,1,0.0
bons,0,0,1,0.007574867880211391,1,0.0
extension,0,0,1,0.007574867880211391,1,0.0
airy,0,0,1,0.007574867880211391,1,0.0
painless,1,0,0,-0.007751027598355844,1,0.0
respective,1,0,0,-0.007751027598355844,1,0.0
opposites,1,0,0,-0.007751027598355844,1,0.0
trifling,1,0,0,-0.007751027598355844,1,0.0
seizing,1,0,0,-0.007751027598355844,1,0.0
tics,1,0,0,-0.007751027598355844,1,0.0
haplessness,1,0,0,-0.007751027598355844,1,0.0
sensational,0,0,1,0.007574867880211391,1,0.0
nonchalant,0,0,1,0.007574867880211391,1,0.0
meshes,0,0,1,0.007574867880211391,1,0.0
congeniality,1,0,0,-0.007751027598355844,1,0.0
vat,1,0,0,-0.007751027598355844,1,0.0
cream,1,0,0,-0.007751027598355844,1,0.0
savvier,0,0,2,0.015208455666470933,2,1.0
spoofs,0,0,2,0.015208455666470933,2,1.0
lulls,0,0,1,0.007574867880211391,1,0.0
griffin,0,0,2,0.015208455666470933,2,1.0
dishes,0,0,1,0.007574867880211391,1,0.0
ton,0,0,1,0.007574867880211391,1,0.0
downplays,0,0,1,0.007574867880211391,1,0.0
outrageousness,0,0,1,0.007574867880211391,1,0.0
beating,0,0,2,0.015208455666470933,2,1.0
outre,0,0,1,0.007574867880211391,1,0.0
dorkier,0,0,1,0.007574867880211391,1,0.0
inseparable,0,0,1,0.007574867880211391,1,0.0
ub,0,0,1,0.007574867880211391,1,0.0
bamboozled,0,0,1,0.007574867880211391,1,0.0
july,0,0,1,0.007574867880211391,1,0.0
strains,0,0,1,0.007574867880211391,1,0.0
buster,0,0,1,0.007574867880211391,1,0.0
affectionately,0,0,1,0.007574867880211391,1,0.0
unafraid,0,0,1,0.007574867880211391,1,0.0
tay,0,0,1,0.007574867880211391,1,0.0
sa,0,0,1,0.007574867880211391,1,0.0
softness,0,0,1,0.007574867880211391,1,0.0
exhausted,0,0,1,0.007574867880211391,1,0.0
aplenty,0,0,1,0.007574867880211391,1,0.0
urine,0,0,1,0.007574867880211391,1,0.0
semen,0,0,1,0.007574867880211391,1,0.0
substances,0,0,1,0.007574867880211391,1,0.0
ridley,0,0,1,0.007574867880211391,1,0.0
prechewed,1,0,0,-0.007751027598355844,1,0.0
traffics,1,0,0,-0.007751027598355844,1,0.0
drill,1,0,0,-0.007751027598355844,1,0.0
discomfiting,0,0,1,0.007574867880211391,1,0.0
bonehead,0,0,1,0.007574867880211391,1,0.0
everytime,0,0,1,0.007574867880211391,1,0.0
steady,0,0,1,0.007574867880211391,1,0.0
tended,1,0,0,-0.007751027598355844,1,0.0
harnessed,0,0,1,0.007574867880211391,1,0.0
bundle,0,0,1,0.007574867880211391,1,0.0
freeze,1,0,0,-0.007751027598355844,1,0.0
hypermasculine,0,0,1,0.007574867880211391,1,0.0
walter,2,0,3,0.0074574280681150885,5,2.321928094887362
pulpy,1,0,1,-0.0001174398120963021,2,1.0
element,0,0,1,0.007574867880211391,1,0.0
bars,0,0,1,0.007574867880211391,1,0.0
bout,1,0,0,-0.007751027598355844,1,0.0
flashbulb,1,0,0,-0.007751027598355844,1,0.0
giler,1,0,0,-0.007751027598355844,1,0.0
punching,1,0,0,-0.007751027598355844,1,0.0
tyson,1,0,0,-0.007751027598355844,1,0.0
mcqueen,0,0,1,0.007574867880211391,1,0.0
outta,0,0,1,0.007574867880211391,1,0.0
ringside,0,0,1,0.007574867880211391,1,0.0
siegel,1,0,1,-0.0001174398120963021,2,1.0
salvage,1,0,0,-0.007751027598355844,1,0.0
coy,0,0,1,0.007574867880211391,1,0.0
wesley,0,0,1,0.007574867880211391,1,0.0
ving,0,0,1,0.007574867880211391,1,0.0
aldrich,1,0,0,-0.007751027598355844,1,0.0
1940s,0,0,1,0.007574867880211391,1,0.0
compliment,0,0,1,0.007574867880211391,1,0.0
gambit,0,0,1,0.007574867880211391,1,0.0
inevitability,0,0,1,0.007574867880211391,1,0.0
boosted,0,0,1,0.007574867880211391,1,0.0
unfaithful,6,0,6,-0.00041103934233705647,12,3.5849625007211565
unlikeable,1,0,0,-0.007751027598355844,1,0.0
sexually,1,0,0,-0.007751027598355844,1,0.0
impeccably,1,0,0,-0.007751027598355844,1,0.0
dragged,1,0,0,-0.007751027598355844,1,0.0
unconditional,0,0,2,0.015208455666470933,2,1.0
liberates,0,0,1,0.007574867880211391,1,0.0
imprisons,0,0,1,0.007574867880211391,1,0.0
belle,0,0,1,0.007574867880211391,1,0.0
sexuality,0,0,1,0.007574867880211391,1,0.0
tested,0,0,1,0.007574867880211391,1,0.0
jour,0,0,1,0.007574867880211391,1,0.0
indecent,1,0,1,-0.0001174398120963021,2,1.0
½,1,0,1,-0.0001174398120963021,2,1.0
martinez,0,0,1,0.007574867880211391,1,0.0
framed,1,0,0,-0.007751027598355844,1,0.0
soupcon,1,0,0,-0.007751027598355844,1,0.0
smut,1,0,0,-0.007751027598355844,1,0.0
meaningfulness,1,0,0,-0.007751027598355844,1,0.0
steamy,2,0,0,-0.015443335290663537,2,1.0
rembrandt,1,0,0,-0.007751027598355844,1,0.0
cheats,1,0,0,-0.007751027598355844,1,0.0
retreats,1,0,0,-0.007751027598355844,1,0.0
lyne,4,0,3,-0.007927187316500297,7,2.807354922057604
frenchman,0,0,1,0.007574867880211391,1,0.0
eroded,1,0,0,-0.007751027598355844,1,0.0
simplest,0,0,1,0.007574867880211391,1,0.0
dumplings,1,0,0,-0.007751027598355844,1,0.0
pork,1,0,0,-0.007751027598355844,1,0.0
wondered,0,0,1,0.007574867880211391,1,0.0
input,0,0,1,0.007574867880211391,1,0.0
adrian,2,0,1,-0.007809747504403995,3,1.5849625007211563
attracting,0,0,1,0.007574867880211391,1,0.0
insensitive,1,0,0,-0.007751027598355844,1,0.0
hurting,1,0,0,-0.007751027598355844,1,0.0
excruciatingly,1,0,0,-0.007751027598355844,1,0.0
entered,1,0,0,-0.007751027598355844,1,0.0
literal,1,0,0,-0.007751027598355844,1,0.0
nutjob,1,0,0,-0.007751027598355844,1,0.0
scorcher,0,0,1,0.007574867880211391,1,0.0
tease,0,0,1,0.007574867880211391,1,0.0
moralizing,1,0,0,-0.007751027598355844,1,0.0
chuckling,1,0,0,-0.007751027598355844,1,0.0
undecided,0,0,1,0.007574867880211391,1,0.0
alvin,0,0,1,0.007574867880211391,1,0.0
broyles,0,0,1,0.007574867880211391,1,0.0
sargent,0,0,1,0.007574867880211391,1,0.0
standout,0,0,1,0.007574867880211391,1,0.0
waking,3,0,1,-0.015502055196711688,4,2.0
sling,1,0,0,-0.007751027598355844,1,0.0
inhuman,1,0,0,-0.007751027598355844,1,0.0
degrades,1,0,0,-0.007751027598355844,1,0.0
squandering,2,0,0,-0.015443335290663537,2,1.0
unamusing,1,0,0,-0.007751027598355844,1,0.0
reckless,1,0,0,-0.007751027598355844,1,0.0
pabst,0,0,1,0.007574867880211391,1,0.0
ribbon,0,0,1,0.007574867880211391,1,0.0
springer,1,0,0,-0.007751027598355844,1,0.0
condescending,1,0,0,-0.007751027598355844,1,0.0
yep,1,0,0,-0.007751027598355844,1,0.0
sweep,1,0,0,-0.007751027598355844,1,0.0
zingers,1,0,0,-0.007751027598355844,1,0.0
brady,2,0,0,-0.015443335290663537,2,1.0
prosaic,1,0,0,-0.007751027598355844,1,0.0
horribly,1,0,0,-0.007751027598355844,1,0.0
truckzilla,1,0,0,-0.007751027598355844,1,0.0
worldly,1,0,0,-0.007751027598355844,1,0.0
peroxide,1,0,0,-0.007751027598355844,1,0.0
arkansas,1,0,0,-0.007751027598355844,1,0.0
honeys,1,0,0,-0.007751027598355844,1,0.0
betray,1,0,0,-0.007751027598355844,1,0.0
foursome,1,0,0,-0.007751027598355844,1,0.0
topnotch,1,0,0,-0.007751027598355844,1,0.0
shoving,1,0,0,-0.007751027598355844,1,0.0
condescension,1,0,0,-0.007751027598355844,1,0.0
pore,1,0,0,-0.007751027598355844,1,0.0
aborted,1,0,0,-0.007751027598355844,1,0.0
markers,1,0,0,-0.007751027598355844,1,0.0
mama,1,0,0,-0.007751027598355844,1,0.0
hillbilly,1,0,0,-0.007751027598355844,1,0.0
hillbillies,1,0,0,-0.007751027598355844,1,0.0
patronising,1,0,0,-0.007751027598355844,1,0.0
wallace,7,0,3,-0.031004110393423375,10,3.3219280948873626
fabricated,1,0,0,-0.007751027598355844,1,0.0
itching,1,0,0,-0.007751027598355844,1,0.0
tack,1,0,0,-0.007751027598355844,1,0.0
burning,2,0,0,-0.015443335290663537,2,1.0
drang,1,0,1,-0.0001174398120963021,2,1.0
bled,1,0,0,-0.007751027598355844,1,0.0
ia,1,0,1,-0.0001174398120963021,2,1.0
crisply,1,0,0,-0.007751027598355844,1,0.0
madebut,1,0,0,-0.007751027598355844,1,0.0
waxes,1,0,0,-0.007751027598355844,1,0.0
object,0,0,1,0.007574867880211391,1,0.0
patriotic,0,0,1,0.007574867880211391,1,0.0
dramatizing,0,0,1,0.007574867880211391,1,0.0
rah,0,0,2,0.015208455666470933,2,1.0
randall,3,0,2,-0.007868467410452145,5,2.321928094887362
telegrams,0,0,1,0.007574867880211391,1,0.0
vary,0,0,1,0.007574867880211391,1,0.0
deafening,0,0,1,0.007574867880211391,1,0.0
pathology,0,0,1,0.007574867880211391,1,0.0
detract,0,0,1,0.007574867880211391,1,0.0
megastar,0,0,1,0.007574867880211391,1,0.0
eulogizes,1,0,0,-0.007751027598355844,1,0.0
unbalanced,1,0,0,-0.007751027598355844,1,0.0
distinguishing,1,0,0,-0.007751027598355844,1,0.0
distinguishes,1,0,0,-0.007751027598355844,1,0.0
waving,0,0,1,0.007574867880211391,1,0.0
flag,0,0,1,0.007574867880211391,1,0.0
pearl,1,0,0,-0.007751027598355844,1,0.0
irrepressible,1,0,0,-0.007751027598355844,1,0.0
braveheart,1,0,0,-0.007751027598355844,1,0.0
overreaching,0,0,1,0.007574867880211391,1,0.0
attributing,0,0,1,0.007574867880211391,1,0.0
mar,0,0,1,0.007574867880211391,1,0.0
16,0,0,1,0.007574867880211391,1,0.0
rambo,1,0,0,-0.007751027598355844,1,0.0
literature,0,0,1,0.007574867880211391,1,0.0
unassuageable,0,0,1,0.007574867880211391,1,0.0
cruelty,0,0,1,0.007574867880211391,1,0.0
iliad,0,0,1,0.007574867880211391,1,0.0
fought,0,0,1,0.007574867880211391,1,0.0
adversaries,0,0,2,0.015208455666470933,2,1.0
bestows,0,0,1,0.007574867880211391,1,0.0
veterans,0,0,1,0.007574867880211391,1,0.0
generously,0,0,1,0.007574867880211391,1,0.0
apolitically,0,0,1,0.007574867880211391,1,0.0
settled,0,0,1,0.007574867880211391,1,0.0
corniest,0,0,1,0.007574867880211391,1,0.0
romanced,0,0,1,0.007574867880211391,1,0.0
lauper,0,0,1,0.007574867880211391,1,0.0
excessively,0,0,1,0.007574867880211391,1,0.0
underconfident,0,0,1,0.007574867880211391,1,0.0
cyndi,0,0,1,0.007574867880211391,1,0.0
walken,0,0,1,0.007574867880211391,1,0.0
spotting,0,0,1,0.007574867880211391,1,0.0
locals,0,0,1,0.007574867880211391,1,0.0
cleveland,0,0,1,0.007574867880211391,1,0.0
envious,0,0,1,0.007574867880211391,1,0.0
collinwood,3,0,0,-0.02313564298297123,3,1.5849625007211563
conspiracies,1,0,0,-0.007751027598355844,1,0.0
apartheid,1,0,0,-0.007751027598355844,1,0.0
encompasses,0,0,1,0.007574867880211391,1,0.0
enormously,0,0,1,0.007574867880211391,1,0.0
russos,2,0,0,-0.015443335290663537,2,1.0
flailing,1,0,0,-0.007751027598355844,1,0.0
lookin,0,0,1,0.007574867880211391,1,0.0
sturges,0,0,1,0.007574867880211391,1,0.0
mamet,0,0,1,0.007574867880211391,1,0.0
charma,0,0,1,0.007574867880211391,1,0.0
cheerfully,0,0,1,0.007574867880211391,1,0.0
shambling,0,0,1,0.007574867880211391,1,0.0
furiously,0,0,1,0.007574867880211391,1,0.0
advised,1,0,0,-0.007751027598355844,1,0.0
scratching,1,0,0,-0.007751027598355844,1,0.0
participate,1,0,0,-0.007751027598355844,1,0.0
earnestly,1,0,0,-0.007751027598355844,1,0.0
busting,1,0,0,-0.007751027598355844,1,0.0
expend,1,0,0,-0.007751027598355844,1,0.0
progress,1,0,0,-0.007751027598355844,1,0.0
megaplexes,1,0,0,-0.007751027598355844,1,0.0
sketchy,1,0,0,-0.007751027598355844,1,0.0
inexplicably,1,0,0,-0.007751027598355844,1,0.0
faintly,1,0,0,-0.007751027598355844,1,0.0
kaputschnik,0,0,1,0.007574867880211391,1,0.0
bellini,0,0,2,0.015208455666470933,2,1.0
jell,1,0,0,-0.007751027598355844,1,0.0
nowheresville,1,0,0,-0.007751027598355844,1,0.0
patois,0,0,1,0.007574867880211391,1,0.0
mullinski,0,0,1,0.007574867880211391,1,0.0
breezes,0,0,1,0.007574867880211391,1,0.0
84,0,0,1,0.007574867880211391,1,0.0
thoughtfully,0,0,1,0.007574867880211391,1,0.0
ephemeral,1,0,0,-0.007751027598355844,1,0.0
venerable,0,0,1,0.007574867880211391,1,0.0
loopiness,1,0,0,-0.007751027598355844,1,0.0
rag,1,0,0,-0.007751027598355844,1,0.0
overwritten,1,0,0,-0.007751027598355844,1,0.0
comically,0,0,1,0.007574867880211391,1,0.0
aloft,0,0,1,0.007574867880211391,1,0.0
clicks,1,0,0,-0.007751027598355844,1,0.0
runyon,1,0,0,-0.007751027598355844,1,0.0
engagingly,1,0,0,-0.007751027598355844,1,0.0
slob,1,0,0,-0.007751027598355844,1,0.0
malle,1,0,0,-0.007751027598355844,1,0.0
reductions,1,0,0,-0.007751027598355844,1,0.0
lohman,0,0,4,0.03047563123899002,4,2.0
allison,0,0,1,0.007574867880211391,1,0.0
slivers,0,0,1,0.007574867880211391,1,0.0
impressions,0,0,1,0.007574867880211391,1,0.0
leaping,0,0,1,0.007574867880211391,1,0.0
traits,0,0,1,0.007574867880211391,1,0.0
kosminsky,0,0,5,0.03810921902524956,5,2.321928094887362
sacrifices,1,0,0,-0.007751027598355844,1,0.0
rebellion,0,0,1,0.007574867880211391,1,0.0
accommodate,0,0,1,0.007574867880211391,1,0.0
heartbreak,0,0,1,0.007574867880211391,1,0.0
arduous,0,0,1,0.007574867880211391,1,0.0
domineering,0,0,1,0.007574867880211391,1,0.0
homes,0,0,1,0.007574867880211391,1,0.0
incredible,0,0,1,0.007574867880211391,1,0.0
blew,0,0,1,0.007574867880211391,1,0.0
erects,0,0,1,0.007574867880211391,1,0.0
adapts,0,0,1,0.007574867880211391,1,0.0
moist,0,0,1,0.007574867880211391,1,0.0
bedevils,0,0,1,0.007574867880211391,1,0.0
reader,0,0,1,0.007574867880211391,1,0.0
akin,0,0,1,0.007574867880211391,1,0.0
nerved,0,0,1,0.007574867880211391,1,0.0
dresses,1,0,0,-0.007751027598355844,1,0.0
materials,1,0,0,-0.007751027598355844,1,0.0
cynic,1,0,0,-0.007751027598355844,1,0.0
reduction,1,0,0,-0.007751027598355844,1,0.0
bone,0,0,1,0.007574867880211391,1,0.0
oprahfication,0,0,1,0.007574867880211391,1,0.0
retains,0,0,1,0.007574867880211391,1,0.0
forum,0,0,1,0.007574867880211391,1,0.0
disappointment,1,0,0,-0.007751027598355844,1,0.0
windtalkers,8,0,3,-0.03869641808573107,11,3.4594316186372978
balletic,0,0,1,0.007574867880211391,1,0.0
directive,0,0,1,0.007574867880211391,1,0.0
merge,0,0,1,0.007574867880211391,1,0.0
privates,1,0,0,-0.007751027598355844,1,0.0
passage,1,0,0,-0.007751027598355844,1,0.0
sainthood,1,0,0,-0.007751027598355844,1,0.0
dogged,1,0,0,-0.007751027598355844,1,0.0
inexorable,1,0,0,-0.007751027598355844,1,0.0
filmcomes,0,0,1,0.007574867880211391,1,0.0
squandered,1,0,0,-0.007751027598355844,1,0.0
choreographed,1,0,0,-0.007751027598355844,1,0.0
debris,0,0,1,0.007574867880211391,1,0.0
norris,1,0,0,-0.007751027598355844,1,0.0
grenade,2,0,0,-0.015443335290663537,2,1.0
indication,1,0,0,-0.007751027598355844,1,0.0
bulk,1,0,0,-0.007751027598355844,1,0.0
undermine,1,0,0,-0.007751027598355844,1,0.0
instincts,1,0,0,-0.007751027598355844,1,0.0
stereotyped,1,0,0,-0.007751027598355844,1,0.0
ravaging,0,0,1,0.007574867880211391,1,0.0
disguised,1,0,0,-0.007751027598355844,1,0.0
heartily,1,0,0,-0.007751027598355844,1,0.0
layer,2,0,0,-0.015443335290663537,2,1.0
atop,1,0,0,-0.007751027598355844,1,0.0
amorality,1,0,0,-0.007751027598355844,1,0.0
peculiarly,1,0,0,-0.007751027598355844,1,0.0
piles,1,0,0,-0.007751027598355844,1,0.0
hoo,1,0,0,-0.007751027598355844,1,0.0
specious,1,0,0,-0.007751027598355844,1,0.0
navajos,1,0,0,-0.007751027598355844,1,0.0
ha,1,0,0,-0.007751027598355844,1,0.0
gratifying,0,0,1,0.007574867880211391,1,0.0
shapelessly,0,0,1,0.007574867880211391,1,0.0
juncture,1,0,0,-0.007751027598355844,1,0.0
sabotages,1,0,0,-0.007751027598355844,1,0.0
ransacked,1,0,0,-0.007751027598355844,1,0.0
talkers,1,0,0,-0.007751027598355844,1,0.0
blasting,1,0,0,-0.007751027598355844,1,0.0
airs,1,0,0,-0.007751027598355844,1,0.0
grass,0,0,1,0.007574867880211391,1,0.0
concocted,1,0,0,-0.007751027598355844,1,0.0
triple,0,0,2,0.015208455666470933,2,1.0
thrashing,1,0,0,-0.007751027598355844,1,0.0
amped,1,0,0,-0.007751027598355844,1,0.0
demographics,1,0,0,-0.007751027598355844,1,0.0
posturing,0,0,1,0.007574867880211391,1,0.0
refitted,0,0,1,0.007574867880211391,1,0.0
fist,0,0,1,0.007574867880211391,1,0.0
aaa,0,0,1,0.007574867880211391,1,0.0
eee,0,0,1,0.007574867880211391,1,0.0
detriments,0,0,1,0.007574867880211391,1,0.0
orgy,0,0,1,0.007574867880211391,1,0.0
slapped,0,0,1,0.007574867880211391,1,0.0
curmudgeon,1,0,0,-0.007751027598355844,1,0.0
suavity,1,0,0,-0.007751027598355844,1,0.0
classical,1,0,0,-0.007751027598355844,1,0.0
flagrant,0,0,1,0.007574867880211391,1,0.0
gauche,0,0,1,0.007574867880211391,1,0.0
engineers,0,0,1,0.007574867880211391,1,0.0
telephone,0,0,1,0.007574867880211391,1,0.0
petri,0,0,1,0.007574867880211391,1,0.0
tats,0,0,1,0.007574867880211391,1,0.0
village,1,0,0,-0.007751027598355844,1,0.0
boost,0,0,1,0.007574867880211391,1,0.0
lowered,0,0,1,0.007574867880211391,1,0.0
crapulence,1,0,0,-0.007751027598355844,1,0.0
tattoo,0,0,1,0.007574867880211391,1,0.0
brandishing,1,0,0,-0.007751027598355844,1,0.0
subservient,1,0,0,-0.007751027598355844,1,0.0
youthful,1,0,0,-0.007751027598355844,1,0.0
gland,0,0,1,0.007574867880211391,1,0.0
fearsome,0,0,1,0.007574867880211391,1,0.0
busts,0,0,1,0.007574867880211391,1,0.0
adrenal,0,0,1,0.007574867880211391,1,0.0
farmer,0,0,1,0.007574867880211391,1,0.0
seizes,0,0,1,0.007574867880211391,1,0.0
epileptic,0,0,1,0.007574867880211391,1,0.0
banging,1,0,0,-0.007751027598355844,1,0.0
salesmanship,1,0,0,-0.007751027598355844,1,0.0
brawny,1,0,0,-0.007751027598355844,1,0.0
